Season,Team,League,GP,G,A,TP,PIM,PlusMinus,PlayerID
1999-00,Univ. of Wisconsin,NCAA,38,28,28,56,32,,3664
1999-00,Canada U20,WJC-20,7,2,2,4,4,-1,3664
1999-00,Univ. of Wisconsin,NCAA,38,28,28,56,32,,3664
1999-00,Canada U20,WJC-20,7,2,2,4,4,-1,3664
1999-00,HK Dukla Trencin,Slovakia,50,25,21,46,34,,3665
1999-00,Slovakia U18,WJC-18,6,6,2,8,12,3,3665
1999-00,Slovakia U20,WJC-20,7,3,1,4,0,0,3665
1999-00,Brampton Battalion,OHL,67,16,29,45,174,3,8622
1999-00,Brampton Battalion,OHL,68,43,48,91,40,6,8857
1999-00,Prince Albert Raiders,WHL,62,27,55,82,124,13,8764
1999-00,Leksands IF J18,J18 Allsvenskan,0,0,0,0,0,,339
1999-00,Leksands IF J20,SuperElit,34,16,22,38,50,,339
1999-00,Leksands IF,SHL,5,0,0,0,4,-2,339
1999-00,Sweden U18,WJC-18,6,0,0,0,2,2,339
1999-00,Sweden U18 (all),International-Jr,17,3,4,7,24,,339
1999-00,Erie Otters,OHL,64,24,29,53,42,-3,10221
1999-00,Lada Togliatti-2,Russia3,35,12,12,24,34,,8648
1999-00,Russia U18,WJC-18,6,1,5,6,2,6,8648
1999-00,Torpedo Yaroslavl,Russia,8,2,0,2,4,,9561
1999-00,Torpedo Yaroslavl-2,Russia3,40,19,15,34,20,,9561
1999-00,Russia U18,WJC-18,6,2,6,8,10,4,9561
1999-00,Dynamo Moskva,Russia,1,0,0,0,0,,9555
1999-00,Dynamo Moskva-2,Russia3,12,5,3,8,34,,9555
1999-00,THK Tver,Russia2,28,3,1,4,53,,9555
1999-00,Russia U18,WJC-18,6,3,4,7,16,9,9555
1999-00,UMass-Lowell,NCAA,30,3,8,11,20,1,9037
1999-00,USA U20,WJC-20,7,1,1,2,4,1,9037
1999-00,HC Ceské Budejovice U20,Czech U20,14,4,7,11,4,3,8710
1999-00,HC Ceske Budejovice,Czech,38,8,6,14,6,4,8710
1999-00,Czech Republic U18,WJC-18,6,4,1,5,0,2,8710
1999-00,Czech Republic U20,WJC-20,7,0,1,1,6,4,8710
1999-00,Torpedo Yaroslavl,Russia,3,0,0,0,4,,21005
1999-00,Torpedo Yaroslavl-2,Russia3,15,4,5,9,14,,21005
1999-00,Portland Winter Hawks,WHL,60,24,29,53,58,-8,4532
1999-00,Slovakia U20,WJC-20,7,0,1,1,8,-1,4532
1999-00,Lokomotiv Yaroslavl-2,Russia3,53,24,17,41,4,,9353
1999-00,Boston College,NCAA,38,1,9,10,102,0,8939
1999-00,USA U20,WJC-20,7,1,1,2,6,3,8939
1999-00,Boston College,NCAA,42,16,16,32,48,0,8716
1999-00,Lokomotiv Yaroslavl-2,Russia3,25,11,13,24,10,,8591
1999-00,Russia U18,WJC-18,6,5,1,6,10,5,8591
1999-00,CSKA Moskva-2,Russia3,6,0,1,1,10,,8660
1999-00,CSKA Moskva,Russia2,31,2,9,11,40,,8660
1999-00,Russia U18,WJC-18,6,1,0,1,6,11,8660
1999-00,Sioux City Musketeers,USHL,54,6,18,24,187,,9038
1999-00,Swift Current Broncos,WHL,70,21,28,49,72,10,11028
1999-00,Erie Otters,OHL,68,36,46,82,38,8,9092
1999-00,Canada U18,Nations Cup,3,0,3,3,4,,9092
1999-00,Windsor Spitfires,OHL,66,23,39,62,131,-9,8944
1999-00,Moose Jaw Warriors,WHL,47,18,17,35,102,-11,8898
1999-00,MoDo Hockey J18,J18 Allsvenskan,0,0,0,0,0,,461
1999-00,MoDo Hockey J20,SuperElit,19,9,8,17,18,,461
1999-00,Sweden U18,WJC-18,6,3,5,8,6,6,461
1999-00,Sweden U18 (all),International-Jr,7,3,5,8,8,,461
1999-00,Plymouth Whalers,OHL,68,37,46,83,46,47,4506
1999-00,Djurgårdens IF,SHL,37,1,4,5,16,0,69
1999-00,Sweden U20,WJC-20,7,5,1,6,10,7,69
1999-00,Sweden U20 (all),International-Jr,15,7,2,9,28,,69
1999-00,Univ. of Minnesota,NCAA,39,10,10,20,22,,9385
1999-00,USA U20,WJC-20,7,1,4,5,2,1,9385
1999-00,Dynamo Moskva-2,Russia3,4,2,1,3,10,,9558
1999-00,THK Tver,Russia2,39,3,6,9,84,,9558
1999-00,Russia U18,WJC-18,6,1,1,2,10,2,9558
1999-00,Plymouth Whalers,OHL,64,36,28,64,37,20,7503
1999-00,Prince Albert Raiders,WHL,72,11,33,44,38,-24,8597
1999-00,Canada U18,Nations Cup,3,0,1,1,0,,8597
1999-00,Neftyanik Leninogorsk,Russia2,2,2,0,2,2,,9562
1999-00,Ak Bars Kazan,Russia,14,1,1,2,4,,9562
1999-00,Ak Bars Kazan-2,Russia3,16,16,4,20,12,,9562
1999-00,Russia U18,WJC-18,6,3,4,7,8,11,9562
1999-00,Univ. of Wisconsin,NCAA,33,9,9,18,48,,8830
1999-00,USA U20,WJC-20,7,0,0,0,6,-2,8830
1999-00,Leksands IF J18,J18 Allsvenskan,1,2,0,2,2,,355
1999-00,Leksands IF J20,SuperElit,34,15,12,27,65,,355
1999-00,Leksands IF,SHL,3,0,0,0,2,0,355
1999-00,Sweden U18,WJC-18,6,0,2,2,10,1,355
1999-00,Sweden U18 (all),International-Jr,17,1,4,5,24,,355
1999-00,Univ. of Michigan,NCAA,38,17,16,33,43,7,9052
1999-00,USA U20,WJC-20,7,1,1,2,0,0,9052
1999-00,HK Dukla Trencin U20,Slovakia U20,14,8,9,17,12,,9642
1999-00,HK Dukla Trencin,Slovakia,52,3,4,7,24,,9642
1999-00,Slovakia U18,WJC-18,1,0,0,0,0,0,9642
1999-00,Slovakia U20,WJC-20,7,0,2,2,4,3,9642
1999-00,Jokerit U18,Jr. B SM-sarja,5,3,4,7,8,,3183
1999-00,Jokerit U20,Jr. A SM-liiga,23,5,9,14,42,,3183
1999-00,Jokerit,Liiga,14,1,1,2,8,0,3183
1999-00,Finland U18,WJC-18,7,1,4,5,8,5,3183
1999-00,Finland U20,WJC-20,7,1,0,1,6,0,3183
1999-00,Finland U20 (all),International-Jr,12,2,0,2,12,,3183
1999-00,Peterborough Petes,OHL,68,6,18,24,116,12,9156
1999-00,Jokerit U20,Jr. A SM-liiga,31,4,4,8,53,,3189
1999-00,Finland U18,WJC-18,7,2,2,4,8,1,3189
1999-00,Plymouth Whalers,OHL,68,0,15,15,208,24,10854
1999-00,Univ. of Denver,NCAA,19,2,6,8,49,3,8769
1999-00,Calgary Hitmen,WHL,27,14,6,20,41,7,8769
1999-00,Canada U20,WJC-20,7,4,0,4,4,0,8769
1999-00,Kootenay Ice,WHL,71,37,38,75,64,1,8895
1999-00,Kootenay Ice,M-Cup,3,0,2,2,2,,8895
1999-00,Kamloops Blazers,WHL,57,17,38,55,70,4,9521
1999-00,Seattle Thunderbirds,WHL,68,11,25,36,38,1,39313
1999-00,Leksands IF J18,J18 Allsvenskan,1,0,2,2,0,,354
1999-00,Leksands IF J20,SuperElit,34,15,24,39,32,,354
1999-00,Leksands IF,SHL,3,0,0,0,0,0,354
1999-00,Sweden U18,WJC-18,6,2,4,6,0,2,354
1999-00,Sweden U18 (all),International-Jr,16,6,9,15,6,,354
1999-00,Krylia Sovetov Moskva,Russia2,32,8,8,16,28,,9554
1999-00,Russia U18,WJC-18,6,0,1,1,6,12,9554
1999-00,Plymouth Whalers,OHL,64,16,22,38,63,8,9446
1999-00,Seattle Thunderbirds,WHL,70,23,32,55,62,10,12253
1999-00,Torpedo Yaroslavl,Russia,7,0,0,0,12,,19111
1999-00,Torpedo Yaroslavl-2,Russia3,32,11,10,21,89,,19111
1999-00,Russia U18,WJC-18,6,3,2,5,4,6,19111
1999-00,MIF Redhawks,SHL,49,8,11,19,88,5,726
1999-00,Sweden (all),International,4,3,1,4,4,,726
1999-00,Victoriaville Tigres,QMJHL,71,30,41,71,87,-12,8840
1999-00,Lokomotiv Yaroslavl-2,Russia3,38,24,10,34,57,,9602
1999-00,Univ. of Minnesota,NCAA,39,1,6,7,82,,11515
1999-00,Kristall Saratov,Russia2,4,0,0,0,6,,59476
1999-00,Langley Hornets,BCHL,49,53,51,104,72,,7605
1999-00,Swift Current Broncos,WHL,71,2,12,14,114,16,9632
1999-00,Elk River High,USHS-MN,24,15,35,50,26,,8778
1999-00,Owen Sound Platers,OHL,65,7,25,32,56,3,12550
1999-00,Latvia U18,WJC-18 B,5,2,1,3,6,3,12550
1999-00,Latvia U20,WJC-20 B,5,0,1,1,8,1,12550
1999-00,Regina Pats,WHL,47,7,32,39,70,1,8663
1999-00,Seattle Thunderbirds,WHL,60,23,34,57,69,11,29020
1999-00,HIFK U20,Jr. A SM-liiga,37,2,5,7,22,,3188
1999-00,Finland U18,WJC-18,7,1,1,2,22,3,3188
1999-00,Newmarket Hurricanes,OPJHL,47,50,32,82,52,,15090
1999-00,Israel,WC D,4,6,6,12,6,12,15090
1999-00,Västra Frölunda HC J18,J18 Allsvenskan,4,2,4,6,4,,305
1999-00,Västra Frölunda HC J20,SuperElit,25,7,12,19,2,,305
1999-00,Sweden U18,WJC-18,6,3,1,4,2,2,305
1999-00,Sweden U18 (all),International-Jr,12,6,7,13,18,,305
1999-00,Moose Jaw Warriors,WHL,72,30,30,60,101,-4,61675
1999-00,Rimouski Océanic,QMJHL,53,26,43,69,61,13,13797
1999-00,Rimouski Océanic,M-Cup,4,0,2,2,4,,13797
1999-00,MoDo Hockey J18,J18 Allsvenskan,1,0,1,1,0,,632
1999-00,MoDo Hockey J20,SuperElit,33,5,5,10,56,,632
1999-00,Sweden U18,WJC-18,5,0,0,0,14,2,632
1999-00,Sweden U18 (all),International-Jr,16,1,0,1,24,,632
1999-00,Metallurg Novokuznetsk,Russia,28,0,2,2,16,,12285
1999-00,Russia U20,WJC-20,7,2,3,5,6,9,12285
1999-00,Lokomotiv Yaroslavl-2,Russia3,31,17,16,33,-,,12250
1999-00,Belleville Bulls,OHL,60,40,36,76,52,18,10313
1999-00,Erie Otters,OHL,58,32,21,53,134,4,8922
1999-00,Deerfield Academy,USHS-Prep,-,-,-,-,-,,59477
1999-00,Portland Winter Hawks,WHL,65,22,23,45,33,-14,9641
1999-00,Slovakia U18,WJC-18,6,0,5,5,4,-1,9641
1999-00,Brampton Battalion,OHL,58,0,8,8,81,-3,15949
1999-00,Univ. of North Dakota,NCAA,44,17,23,40,30,,10253
1999-00,Dynamo Moskva,Russia,35,14,20,34,26,,12452
1999-00,Russia,WC,6,2,3,5,2,6,12452
1999-00,Dynamo Moskva,Euro HL,6,3,3,6,2,5,12452
1999-00,Moose Jaw Warriors,WHL,51,5,8,13,166,-2,15249
1999-00,Lada Togliatti-2,Russia3,2,1,1,2,0,,60498
1999-00,CSK VVS Samara,Russia,17,0,1,1,14,,60498
1999-00,Lada Togliatti,Russia,8,0,0,0,6,,60498
1999-00,Russia U20,WJC-20,7,3,2,5,4,7,60498
1999-00,Acadie-Bathurst Titan,QMJHL,13,10,11,21,61,10,9685
1999-00,Halifax Mooseheads,QMJHL,59,57,80,137,148,29,9685
1999-00,Halifax Mooseheads,M-Cup,4,6,4,10,8,,9685
1999-00,Baie-Comeau Drakkar,QMJHL,67,31,61,92,14,0,7798
1999-00,HC Slavia Praha U20,Czech U20,22,7,8,15,6,15,25698
1999-00,HC Slavia Praha,Czech,25,1,2,3,4,-5,25698
1999-00,Czech Republic U18,WJC-18,6,1,2,3,2,-3,25698
1999-00,Czech Republic U20,WJC-20,7,0,0,0,0,-1,25698
1999-00,Spokane Chiefs,WHL,71,3,12,15,48,38,8870
1999-00,HC Havirov U20,Czech U20,5,1,3,4,4,6,10217
1999-00,HC Havirov,Czech,40,11,11,22,41,-9,10217
1999-00,HC Ytong Brno,Czech3,4,3,4,7,0,,10217
1999-00,Czech Republic U20,WJC-20,7,1,2,3,4,3,10217
1999-00,Dynamo Moskva,Russia,28,1,1,2,10,,15025
1999-00,Russia U20,WJC-20,7,3,5,8,2,6,15025
1999-00,Dynamo Moskva,Euro HL,3,1,1,2,2,2,15025
1999-00,Dynamo Moskva-2,Russia3,5,0,1,1,4,,60775
1999-00,THK Tver,Russia2,32,5,2,7,12,,60775
1999-00,Soo Indians,NAHL,22,5,11,16,32,,15257
1999-00,Barrie Colts,OHL,38,3,16,19,46,16,15257
1999-00,Barrie Colts,M-Cup,5,0,2,2,6,,15257
1999-00,SKA St. Petersburg-2,Russia3,4,4,1,5,2,,18845
1999-00,SKA St. Petersburg,Russia,31,2,0,2,10,,18845
1999-00,Harvard Univ.,NCAA,30,12,12,24,28,,8964
1999-00,Victoriaville Tigres,QMJHL,24,2,8,10,30,,60777
1999-00,Val-d'Or Foreurs,QMJHL,8,3,1,4,10,,60777
1999-00,Brynäs IF,SHL,48,7,9,16,73,12,745
1999-00,Sweden (all),International,7,0,1,1,4,,745
1999-00,Brynäs IF,Euro HL,5,1,1,2,10,-2,745
1999-00,Luleå HF,SHL,49,15,24,39,42,-8,510
1999-00,Sweden,WC,7,0,3,3,0,-2,510
1999-00,Sweden (all),International,17,4,4,8,2,,510
1999-00,RPI (Rensselaer Polytech. Inst.),NCAA,33,12,18,30,26,,9452
1999-00,Ottawa 67's,OHL,54,20,29,49,73,13,55443
1999-00,Ilves U20,Jr. A SM-liiga,13,3,2,5,24,,3194
1999-00,Ilves,Liiga,42,2,1,3,20,-11,3194
1999-00,Hermes,I-divisioona,3,0,0,0,2,-1,3194
1999-00,Finland U20,WJC-20,7,3,3,6,6,2,3194
1999-00,Finland U20 (all),International-Jr,16,4,5,9,14,,3194
1999-00,Harvard Univ.,NCAA,26,6,11,17,20,,9453
1999-00,USA U20,WJC-20,7,0,1,1,2,-2,9453
1999-00,Providence College,NCAA,38,15,12,27,12,9,9451
1999-00,CSKA Moskva,Russia2,40,11,7,18,32,,18562
1999-00,CSKA Moskva-2,Russia3,9,9,5,14,10,,18562
1999-00,Regina Pats,WHL,67,3,11,14,157,-4,21700
1999-00,Victoriaville Tigres,QMJHL,69,49,76,125,97,3,11547
1999-00,Portland Winter Hawks,WHL,70,20,27,47,96,-26,12724
1999-00,Leksands IF J18,J18 Allsvenskan,0,0,0,0,0,,345
1999-00,Leksands IF J20,SuperElit,36,10,13,23,36,,345
1999-00,Sweden U18,WJC-18,6,2,3,5,6,2,345
1999-00,Sweden U18 (all),International-Jr,17,4,8,12,18,,345
1999-00,Plymouth Whalers,OHL,50,1,15,16,123,11,11610
1999-00,HC Dukla Jihlava U20,Czech U20,27,4,2,6,36,8,27991
1999-00,HC Dukla Jihlava,Czech2,19,0,1,1,10,3,27991
1999-00,HC Dukla Jihlava,Czech Q,-,-,-,-,-,,27991
1999-00,Mississauga IceDogs,OHL,66,21,25,46,46,-69,8096
1999-00,Chicoutimi Saguenéens,QMJHL,69,8,15,23,18,,10884
1999-00,North Bay Centennials,OHL,58,5,25,30,64,-18,17937
1999-00,Jokerit U18,Jr. B SM-sarja,14,6,6,12,14,,3185
1999-00,Jokerit U20,Jr. A SM-liiga,27,3,3,6,12,,3185
1999-00,Finland U18,WJC-18,7,1,1,2,6,0,3185
1999-00,HC Slovan Bratislava,Slovakia,52,21,24,45,38,64,8592
1999-00,Slovakia,WC,9,0,6,6,2,3,8592
1999-00,HC Slovan Bratislava,Euro HL,6,1,1,2,0,5,8592
1999-00,Univ. of Wisconsin,NCAA,41,6,11,17,40,,11569
1999-00,Sarnia Sting,OHL,45,8,20,28,62,-2,17798
1999-00,Springfield Falcons,AHL,2,0,1,1,0,0,17798
1999-00,Fargo-Moorhead Ice Sharks,USHL,50,5,11,16,106,,34272
1999-00,Khimik Voskresensk,Russia2,15,0,0,0,31,,11517
1999-00,Khimik Voskresensk-2,Russia3,9,1,0,1,16,,11517
1999-00,CSKA Moskva-2,Russia2,11,0,1,1,10,,11517
1999-00,Rimouski Océanic,QMJHL,72,36,53,89,38,39,8946
1999-00,Rimouski Océanic,M-Cup,4,1,2,3,2,,8946
1999-00,Lethbridge Hurricanes,WHL,51,1,6,7,112,-3,15899
1999-00,MoDo Hockey J18,J18 Allsvenskan,1,0,1,1,2,,807
1999-00,MoDo Hockey J20,SuperElit,35,7,10,17,75,,807
1999-00,Sweden U18,WJC-18,6,0,1,1,2,2,807
1999-00,Sweden U18 (all),International-Jr,17,4,1,5,10,,807
1999-00,Dynamo Moskva-2,Russia3,5,0,3,3,16,,50296
1999-00,THK Tver,Russia2,16,4,2,6,63,,50296
1999-00,Salavat Yulaev Ufa,Russia,13,1,2,3,4,,19122
1999-00,Salavat Yulaev Ufa-2,Russia3,18,3,4,7,10,,19122
1999-00,Russia U18,WJC-18,6,0,1,1,4,2,19122
1999-00,Des Moines Buccaneers,USHL,53,36,30,66,95,,12877
1999-00,Brampton Battalion,OHL,57,17,20,37,24,-5,60793
1999-00,Blaine High,USHS-MN,21,23,30,53,28,,11554
1999-00,Avangard Omsk,Russia,37,19,24,43,58,,9179
1999-00,Russia,WC,6,3,1,4,0,3,9179
1999-00,Avangard Omsk,Continental Cup,3,1,4,5,0,,9179
1999-00,HC Davos,NLA,40,15,23,38,20,,1797
1999-00,Finland,WC,9,2,4,6,0,7,1797
1999-00,HC Slovan Bratislava,Slovakia,40,4,11,15,63,,12210
1999-00,Slovakia,WC,9,0,1,1,14,-4,12210
1999-00,HC Slovan Bratislava,Euro HL,2,0,0,0,2,-1,12210
1999-00,Barrie Colts,OHL,58,34,53,87,203,32,60843
1999-00,Barrie Colts,M-Cup,5,1,1,2,13,,60843
1999-00,Torpedo Nizhny Novgorod,Russia,36,14,6,20,50,,18844
1999-00,Kazakhstan,WC B,7,6,4,10,16,7,18844
1999-00,Colorado College,NCAA,32,2,5,7,26,,11734
1999-00,USA U20,WJC-20,7,0,0,0,2,0,11734
1999-00,Sarnia Sting,OHL,55,5,10,15,24,8,60902
1999-00,CSKA Moskva,Russia,1,0,0,0,0,,19565
1999-00,Dynamo Moskva,Russia,6,2,1,3,2,,19565
1999-00,THK Tver,Russia2,6,0,0,0,4,,19565
1999-00,Amur Khabarovsk,Russia,14,3,6,9,10,,19565
1999-00,Dynamo Moskva,Euro HL,2,0,0,0,0,1,19565
1999-00,Chilliwack Chiefs,BCHL,59,35,75,110,97,,12617
1999-00,Calgary Hitmen,WHL,61,3,15,18,59,32,22615
1999-00,Rouyn-Noranda Huskies,QMJHL,27,8,16,24,64,-10,24736
1999-00,Hull Olympiques,QMJHL,31,11,27,38,67,15,24736
1999-00,Neftekhimik Nizhnekamsk,Russia,29,2,5,7,14,,44320
1999-00,Ak Bars Kazan,Russia,8,0,1,1,2,,44320
1999-00,Russia U20,WJC-20,7,1,2,3,4,9,44320
1999-00,Walpole Stars,EJHL,42,19,40,59,54,,11730
1999-00,HC Sparta Praha U20,Czech U20,36,0,4,4,79,1,10992
1999-00,Cornell Univ.,NCAA,31,8,16,24,22,,60904
1999-00,Djurgårdens IF,SHL,47,25,15,40,12,20,85
1999-00,Sweden (all),International,8,2,0,2,0,,85
1999-00,HK CSKA Moskva,Russia2,40,1,8,9,20,,9556
1999-00,Russia U20,WJC-20,7,1,1,2,0,3,9556
1999-00,Deerfield Academy,USHS-Prep,-,-,-,-,-,,60905
1999-00,Torpedo Yaroslavl-2,Russia3,38,5,9,14,58,,60906
1999-00,Torpedo Yaroslavl,Russia,28,2,5,7,16,,60906
1999-00,Brampton Battalion,OHL,54,1,0,1,59,-6,15112
1999-00,Boston College,NCAA,41,1,8,9,26,1,60909
1999-00,Twin City Vulcans,USHL,57,24,34,58,19,,10644
1999-00,Kelowna Rockets,WHL,66,9,6,15,96,-13,8535
1999-00,Univ. of Nebraska-Omaha,NCAA,42,3,26,29,56,,10220
1999-00,Lincoln Stars,USHL,56,25,30,55,85,,10503
1999-00,Northern Michigan Univ.,NCAA,35,2,14,16,64,,60914
1999-00,Michigan State Univ.,NCAA,40,8,20,28,26,0,8734
1999-00,Plymouth Whalers,OHL,63,3,5,8,102,18,17101
1999-00,Khimik Voskresensk,Russia2,10,0,0,0,2,,55438
1999-00,Khimik Voskresensk-2,Russia3,21,5,5,10,26,,55438
1999-00,Metallurg Novokuznetsk,Russia,10,2,3,5,0,,16744
1999-00,Metallurg Novokuznetsk-2,Russia3,9,7,4,11,18,,16744
1999-00,Russia U18,WJC-18,6,2,2,4,2,4,16744
1999-00,Lokomotiv Yaroslavl-2,Russia3,43,9,14,23,38,,12249
1999-00,Calgary Canucks,AJHL,53,3,14,17,100,,13414
1999-00,Barrie Colts,OHL,63,2,10,12,85,20,9449
1999-00,Barrie Colts,M-Cup,5,0,1,1,4,,9449
1999-00,MsHKM Zilina U20,Slovakia U20,31,1,9,10,60,,8068
1999-00,MsHK Zilina,Slovakia2,27,0,3,3,34,,8068
1999-00,HIFK,Liiga,46,6,8,14,51,21,2668
1999-00,HIFK,Euro HL,5,2,2,4,31,-1,2668
1999-00,EHC Kloten,NLA,40,6,3,9,28,,9638
1999-00,Kloten U20,Elite Jr. A,2,0,0,0,4,,9638
1999-00,Switzerland U18,WJC-18,7,5,6,11,2,3,9638
1999-00,Switzerland U20,WJC-20,7,2,4,6,2,-1,9638
1999-00,HPK,Liiga,53,17,28,45,76,13,2709
1999-00,Finland,WC,9,3,3,6,12,9,2709
1999-00,Choate Rosemary Hall,USHS-Prep,-,-,-,-,-,,16723
1999-00,Kristall Saratov,Russia2,2,1,0,1,0,,58017
1999-00,Kristall Saratov-2,Russia3,1,0,0,0,4,,58017
1999-00,Kazakhstan U20,WJC-20,7,4,1,5,43,-7,58017
1999-00,Saskatoon Blades,WHL,63,6,8,14,269,5,9056
1999-00,U.S. National U18 Team,NAHL,49,6,28,34,46,,7619
1999-00,USNTDP Juniors,USHL,8,0,0,0,2,,7619
1999-00,HC Plzen U20,Czech U20,29,6,8,14,69,9,60994
1999-00,HC Plzen,Czech,4,0,0,0,2,1,60994
1999-00,Czech Republic U18,WJC-18,5,0,0,0,2,1,60994
1999-00,MHC Martin,Slovakia2,8,1,5,6,4,,10635
1999-00,Slovakia U18,WJC-18,4,1,0,1,2,1,10635
1999-00,Calgary Hitmen,WHL,67,12,13,25,94,11,21101
1999-00,Univ. of New Hampshire,NCAA,30,3,7,10,61,1,9382
1999-00,USA U20,WJC-20,7,1,0,1,31,1,9382
1999-00,Oshawa Generals,OHL,59,34,53,87,74,3,14999
1999-00,Saint John Flames,AHL,2,0,0,0,0,-1,14999
1999-00,Grums IK,Allsvenskan,46,12,10,22,24,-14,102
1999-00,Brampton Battalion,OHL,63,5,27,32,108,-1,60997
1999-00,Clarkson Univ.,NCAA,34,8,10,18,54,,13559
1999-00,Fargo-Moorhead Ice Sharks,USHL,18,2,5,7,37,,12254
1999-00,Omaha Lancers,USHL,43,6,7,13,44,,12254
1999-00,Kamloops Blazers,WHL,68,5,6,11,243,8,55441
1999-00,HC Kladno U20,Czech U20,34,16,15,31,16,11,28514
1999-00,HC Kladno,Czech,21,3,2,5,6,-7,28514
1999-00,HC Kralupy nad Vltavou,Czech3,1,0,1,1,0,,28514
1999-00,HK Slany,Czech3,4,3,0,3,2,,28514
1999-00,Omaha Lancers,USHL,56,1,4,5,41,,43909
1999-00,Moose Jaw Warriors,WHL,55,0,5,5,62,-18,13406
1999-00,Cleveland Barons NAHL,NAHL,55,46,49,95,40,,18379
1999-00,Great Britain U20,WJC-20 C,4,4,5,9,4,4,18379
1999-00,Sault Ste. Marie Greyhounds,OHL,58,4,15,19,60,17,18378
1999-00,HC Vitkovice,Czech,47,7,5,12,12,-17,10870
1999-00,HC Dukla Jihlava,Czech2,1,0,0,0,0,-1,10870
1999-00,Czech Republic U20,WJC-20,7,2,1,3,6,3,10870
1999-00,Vernon Vipers,BCHL,58,31,37,68,88,,15121
1999-00,Oshawa Generals,OHL,58,22,36,58,98,-1,12761
1999-00,TPS U18,Jr. B SM-sarja,6,2,5,7,6,,3213
1999-00,TPS U20,Jr. A SM-liiga,35,10,7,17,32,,3213
1999-00,Finland U18,WJC-18,7,3,5,8,8,5,3213
1999-00,Molot-Prikamie Perm,Russia,37,5,5,10,20,,18377
1999-00,Russia U20,WJC-20,7,1,4,5,4,6,18377
1999-00,Thunder Bay Flyers,USHL,46,3,20,23,152,,11560
1999-00,Sarnia Sting,OHL,62,8,11,19,131,4,61168
1999-00,Västra Frölunda HC J20,SuperElit,36,16,25,41,82,,462
1999-00,Sweden U18,WJC-18,6,2,4,6,16,8,462
1999-00,Sweden U18 (all),International-Jr,17,3,6,9,20,,462
1999-00,Univ. of Maine,NCAA,31,0,5,5,22,5,12848
1999-00,Halifax Mooseheads,QMJHL,62,44,80,124,10,30,9526
1999-00,Canada U20,WJC-20,7,4,5,9,4,3,9526
1999-00,Halifax Mooseheads,M-Cup,4,1,6,7,2,,9526
1999-00,TPS U18,Jr. B SM-sarja,29,16,10,26,8,,3192
1999-00,TPS U20,Jr. A SM-liiga,9,2,1,3,6,,3192
1999-00,Finland U18,WJC-18,7,1,4,5,4,6,3192
1999-00,Green Bay Gamblers,USHL,49,19,50,69,58,,61172
1999-00,Colorado College,NCAA,29,4,5,9,30,,12019
1999-00,Västra Frölunda HC J20,SuperElit,35,45,21,66,30,,303
1999-00,Västra Frölunda HC,SHL,4,0,0,0,0,0,303
1999-00,CSKA Moskva,Russia2,10,2,1,3,2,,18376
1999-00,HC Ceske Budejovice,Czech,52,23,25,48,26,8,18375
1999-00,Slovakia,WC,9,3,1,4,2,5,18375
1999-00,Victoriaville Tigres,QMJHL,65,18,26,44,28,-14,8999
1999-00,Univ. of New Hampshire,NCAA,28,7,6,13,22,0,46603
1999-00,Lokomotiv Yaroslavl-2,Russia3,36,0,2,2,34,,18374
1999-00,Russia U18,WJC-18,6,0,2,2,0,5,18374
1999-00,Seattle Thunderbirds,WHL,65,1,9,10,120,-6,61176
1999-00,TPS,Liiga,54,10,10,20,73,11,3220
1999-00,TPS,Euro HL,5,0,0,0,4,0,3220
1999-00,Burnaby Bulldogs,BCHL,-,-,-,-,-,,8808
1999-00,Portland Winter Hawks,WHL,56,6,8,14,110,-30,8808
1999-00,HC Slovan Bratislava U20,Slovakia2,31,2,9,11,56,,18371
1999-00,HC Slovan Bratislava,Slovakia,6,0,0,0,2,,18371
1999-00,HKM Zvolen U20,Slovakia U20,41,6,8,14,11,,18350
1999-00,HKM Zvolen B,Slovakia2,9,1,0,1,12,-8,18350
1999-00,HKM Zvolen,Slovakia,7,0,0,0,0,0,18350
1999-00,Slovakia U18,WJC-18,6,0,1,1,12,-2,18350
1999-00,HPK U20,Jr. A SM-liiga,15,11,13,24,16,,2698
1999-00,HPK,Liiga,39,2,1,3,8,2,2698
1999-00,Finland U20,WJC-20,7,4,1,5,2,-2,2698
1999-00,Finland U20 (all),International-Jr,16,5,3,8,2,,2698
1999-00,Severstal Cherepovets-2,Russia3,30,23,10,33,36,,18348
1999-00,Russia U18,WJC-18,6,2,0,2,4,3,18348
1999-00,Cape Breton Screaming Eagles,QMJHL,44,26,28,54,82,2,12252
1999-00,Québec Remparts,QMJHL,2,3,1,4,0,2,12252
1999-00,Rouyn-Noranda Huskies,QMJHL,25,4,11,15,39,-12,12252
1999-00,Västerås IK J18,J18 Allsvenskan,5,1,3,4,20,,663
1999-00,Västerås IK J20,SuperElit,29,10,2,12,121,,663
1999-00,Montréal Rocket,QMJHL,4,2,1,3,0,1,15241
1999-00,North Bay Centennials,OHL,48,17,25,42,26,0,3236
1999-00,HC Trinec,Czech,52,7,24,31,42,5,3674
1999-00,Slovakia,WC,7,2,4,6,6,0,3674
1999-00,Essamika/Juniors,Latvia,3,0,1,1,2,,7420
1999-00,Essamika/Juniors,EEHL B,2,4,4,8,0,,7420
1999-00,Lukko U20,Jr. A SM-liiga,26,2,5,7,6,,7420
1999-00,Latvia U18,WJC-18 B,5,5,1,6,14,5,7420
1999-00,Latvia U20,WJC-20 B,5,0,1,1,2,1,7420
1999-00,Latvia,WC,7,0,0,0,0,-1,7420
1999-00,Södertälje SK J18,J18 Allsvenskan,5,0,1,1,8,,245
1999-00,Södertälje SK J20,SuperElit,30,1,0,1,30,,245
1999-00,HC Ceské Budejovice U20,Czech U20,8,4,2,6,26,-1,10849
1999-00,HC Ceske Budejovice,Czech,28,1,0,1,2,3,10849
1999-00,KLH Jindrichuv Hradec,Czech2,4,1,1,2,0,-3,10849
1999-00,IHC Pisek,Czech2,3,1,0,1,0,0,10849
1999-00,Czech Republic U20,WJC-20,7,0,0,0,2,2,10849
1999-00,RPI (Rensselaer Polytech. Inst.),NCAA,21,2,5,7,8,,61185
1999-00,KLH Chomutov U20,Czech U20 2,6,1,5,6,14,,18321
1999-00,KLH Chomutov,Czech2,28,1,5,6,14,4,18321
1999-00,Czech Republic U20,WJC-20,7,1,2,3,6,5,18321
1999-00,Lethbridge Hurricanes,WHL,72,44,38,82,38,-5,10689
1999-00,Univ. of Notre Dame,NCAA,41,4,10,14,54,,61186
1999-00,Portland Winter Hawks,WHL,69,2,5,7,184,-26,61187
1999-00,Univ. of Minnesota,NCAA,36,6,8,14,31,,12780
1999-00,Mississauga IceDogs,OHL,68,23,45,68,53,-52,11753
1999-00,Omaha Lancers,USHL,49,1,6,7,65,,15341
1999-00,Moose Jaw Warriors,WHL,69,22,20,42,91,-21,15119
1999-00,Tappara U20,Jr. A SM-liiga,37,8,9,17,18,,3223
1999-00,HC Fribourg-Gottéron,NLA,44,19,22,41,83,,18518
1999-00,Switzerland U20,WJC-20,7,4,3,7,10,0,18518
1999-00,Switzerland,WC,7,1,0,1,6,-1,18518
1999-00,USNTDP Juniors,USHL,23,8,6,14,12,,13631
1999-00,U.S. National U18 Team,NAHL,29,8,10,18,25,,13631
1999-00,Toronto St. Michael's Majors,OHL,65,24,30,54,166,-21,10999
1999-00,Swift Current Broncos,WHL,67,1,3,4,215,3,61189
1999-00,Severstal Cherepovets,Russia,20,1,1,2,2,,18320
1999-00,Severstal Cherepovets-2,Russia3,16,9,8,17,12,,18320
1999-00,Tri-City Americans,WHL,72,24,36,60,38,-9,6042
1999-00,Ilves,Liiga,50,9,19,28,79,10,3225
1999-00,Lethbridge Hurricanes,WHL,62,2,4,6,39,-20,15330
1999-00,Sarnia Sting,OHL,31,0,1,1,75,-5,22627
1999-00,Kitchener Rangers,OHL,31,0,1,1,67,-1,22627
1999-00,Nipawin Hawks,SJHL,46,8,21,29,20,,12479
1999-00,Lada Togliatti-2,Russia3,53,23,17,40,36,,22137
1999-00,Guelph Storm,OHL,56,3,6,9,40,-9,15658
1999-00,HC Ambrì-Piotta,NLA,45,7,7,14,24,,12660
1999-00,Switzerland,WC,7,2,2,4,0,3,12660
1999-00,HC Ambrì-Piotta,Continental Cup,-,-,-,-,-,,12660
1999-00,Dizel Penza,Russia2,44,10,7,17,40,-13,18319
1999-00,Québec Remparts,QMJHL,34,0,10,10,15,5,9123
1999-00,Cape Breton Screaming Eagles,QMJHL,28,0,4,4,21,-5,9123
1999-00,Northwood School Prep,USHS-Prep,-,54,56,110,-,,18318
1999-00,Ilves,Liiga,51,1,6,7,78,-12,2659
1999-00,HC Slavia Praha,Czech,52,5,3,8,44,3,18317
1999-00,HC Karlovy Vary,Czech,24,0,5,5,18,-7,12255
1999-00,SaiPa,Liiga,26,1,3,4,54,-2,12255
1999-00,Czech Republic,EHT,4,0,2,2,6,,12255
1999-00,Czech Republic (all),International,4,0,2,2,6,,12255
1999-00,Kamloops Blazers,WHL,70,26,52,78,156,27,8062
1999-00,San Diego Gulls,WCHL,0,0,0,0,0,,8062
1999-00,Long Beach Ice Dogs,IHL,1,0,0,0,0,0,8062
1999-00,HC Davos,NLA,45,19,26,45,70,,10822
1999-00,Switzerland,WC,7,1,2,3,2,-1,10822
1999-00,Spokane Chiefs,WHL,71,26,70,96,65,29,24113
1999-00,HPK,Liiga,23,10,17,27,50,6,13654
1999-00,Czech Republic,EHT,7,2,1,3,28,,13654
1999-00,Czech Republic (all),International,8,2,1,3,30,,13654
1999-00,Neftekhimik Nizhnekamsk,Russia,29,9,7,16,2,,9598
1999-00,Ak Bars Kazan,Russia,8,2,2,4,2,,9598
1999-00,Russia U20,WJC-20,7,6,2,8,4,8,9598
1999-00,Rouyn-Noranda Huskies,QMJHL,70,32,49,81,104,,18316
1999-00,Michigan State Univ.,NCAA,42,5,7,12,10,-3,61190
1999-00,Windsor Spitfires,OHL,65,10,22,32,44,10,61191
1999-00,HC Vsetin,Czech,48,11,14,25,26,11,18315
1999-00,HC Vsetin,Euro HL,6,0,1,1,4,-5,18315
1999-00,Luleå HF J18,J18 Allsvenskan,9,2,2,4,14,,187
1999-00,HK Dukla Trencin,Slovakia,54,20,11,31,34,,5873
1999-00,Portland Winter Hawks,WHL,56,2,8,10,181,-23,61192
1999-00,EHC Kloten,NLA,44,4,2,6,20,,12643
1999-00,Kloten U20,Elite Jr. A,0,0,0,0,0,,12643
1999-00,Switzerland U20,WJC-20,7,0,1,1,4,-1,12643
1999-00,Moskitos Essen,DEL,55,3,3,6,26,-17,9672
1999-00,HC Slavia Praha U20,Czech U20,36,17,7,24,24,12,18314
1999-00,HC Slavia Praha,Czech,2,0,0,0,0,-2,18314
1999-00,Cornell Univ.,NCAA,27,5,16,21,10,,83450
1999-00,Djurgårdens IF,SHL,49,17,11,28,62,-6,71
1999-00,Sweden,WC,7,3,3,6,6,5,71
1999-00,Sweden (all),International,25,3,8,11,6,,71
1999-00,Val-d'Or Foreurs,QMJHL,72,64,79,143,74,22,10315
1999-00,EHC Kloten,NLA,34,0,4,4,12,,28082
1999-00,Rouyn-Noranda Huskies,QMJHL,50,5,11,16,31,2,18313
1999-00,Montréal Rocket,QMJHL,69,12,17,29,80,-4,3304
2000-01,Spartak Moskva,Russia2,40,28,18,46,78,,3660
2000-01,Russia U18,WJC-18,6,11,4,15,26,12,3660
2000-01,Russia U20,WJC-20,7,4,2,6,37,0,3660
2000-01,Mississauga IceDogs,OHL,15,7,23,30,11,-5,3661
2000-01,Windsor Spitfires,OHL,41,36,50,86,32,33,3661
2000-01,Canada U20,WJC-20,7,3,3,6,2,-1,3661
2000-01,Avangard Omsk,Russia,39,8,7,15,115,,3662
2000-01,Russia U20,WJC-20,6,0,1,1,58,2,3662
2000-01,Plymouth Whalers,OHL,62,40,47,87,45,28,8817
2000-01,Avangard Omsk,Russia,16,3,7,10,4,,8520
2000-01,Avangard Omsk-2,Russia3,6,5,4,9,2,,8520
2000-01,Russia U18,WJC-18,4,4,2,6,0,4,8520
2000-01,Russia U20,WJC-20,7,5,1,6,0,4,8520
2000-01,TPS U18,Jr. B SM-sarja,0,0,0,0,0,,2696
2000-01,TPS U20,Jr. A SM-liiga,26,9,36,45,26,,2696
2000-01,TPS,Liiga,21,0,1,1,2,-1,2696
2000-01,Finland U18,WJC-18,6,2,3,5,6,1,2696
2000-01,Finland U18 (all),International-Jr,8,2,4,6,6,,2696
2000-01,Finland U20,WJC-20,7,0,3,3,8,3,2696
2000-01,Finland U20 (all),International-Jr,16,1,7,8,12,,2696
2000-01,Univ. of Michigan,NCAA,41,4,12,16,77,17,9019
2000-01,USA U20,WJC-20,7,0,0,0,0,-2,9019
2000-01,Jokerit U20,Jr. A SM-liiga,2,1,0,1,0,,2695
2000-01,Jokerit,Liiga,47,11,11,22,86,7,2695
2000-01,Finland U18 (all),International-Jr,3,0,2,2,2,,2695
2000-01,Finland U20,WJC-20,7,1,3,4,4,5,2695
2000-01,Finland U20 (all),International-Jr,16,3,6,9,53,,2695
2000-01,Västra Frölunda HC J18,J18 Allsvenskan,0,0,0,0,0,0,473
2000-01,Västra Frölunda HC J20,SuperElit,7,2,5,7,6,10,473
2000-01,Västra Frölunda HC,SHL,31,2,3,5,6,-3,473
2000-01,Sweden U18,WJC-18,6,3,3,6,4,-2,473
2000-01,Sweden U18 (all),International-Jr,9,4,5,9,4,,473
2000-01,Sweden U20,WJC-20,7,1,2,3,16,0,473
2000-01,Prince George Cougars,WHL,62,13,46,59,125,-15,9040
2000-01,Canada U20,WJC-20,7,0,1,1,8,2,9040
2000-01,Hull Olympiques,QMJHL,68,36,64,100,67,14,8600
2000-01,Boston College,NCAA,43,27,22,49,38,8,9018
2000-01,Spartak Moskva,Russia2,42,6,3,9,64,,9564
2000-01,Russia U18,WJC-18,6,1,4,5,24,13,9564
2000-01,Ohio State Univ.,NCAA,32,14,23,37,18,1,8820
2000-01,USA U20,WJC-20,7,2,2,4,2,0,8820
2000-01,Erie Otters,OHL,62,12,27,39,59,46,9117
2000-01,Västra Frölunda HC J20,SuperElit,14,8,8,16,68,,304
2000-01,Västra Frölunda HC,SHL,19,2,0,2,4,-2,304
2000-01,IF Mölndal Hockey,Allsvenskan,5,1,1,3,35,-2,304
2000-01,Sweden U19 (all),International-Jr,7,1,1,2,6,,304
2000-01,Kamloops Blazers,WHL,61,13,25,38,132,19,8961
2000-01,SERC Wild Wings,DEL,58,13,28,41,12,-5,8583
2000-01,Germany U18,WJC-18,6,2,4,6,0,-2,8583
2000-01,Germany U20,WJC-20 D1,5,0,1,1,2,1,8583
2000-01,Germany,OGQ,3,0,0,0,0,1,8583
2000-01,Germany,WC,7,0,0,0,2,-4,8583
2000-01,Germany (all),International,14,0,0,0,2,,8583
2000-01,Red Deer Rebels,WHL,72,36,42,78,156,44,9067
2000-01,Red Deer Rebels,M-Cup,4,1,0,1,12,-2,9067
2000-01,HC Ceské Budejovice U20,Czech U20,37,12,14,26,40,-6,8675
2000-01,HC Ceske Budejovice,Czech,19,0,4,4,2,-2,8675
2000-01,KLH Jindrichuv Hradec,Czech3,0,0,0,0,0,,8675
2000-01,Czech Republic U18,WJC-18,6,4,3,7,2,-1,8675
2000-01,Czech Republic U18 (all),International-Jr,24,4,3,7,2,,8675
2000-01,Windsor Spitfires,OHL,47,8,28,36,124,28,9162
2000-01,USA U20,WJC-20,7,0,1,1,2,5,9162
2000-01,Peterborough Petes,OHL,61,8,27,35,53,2,8550
2000-01,Avangard Omsk,Russia,0,0,0,0,0,,8669
2000-01,Avangard Omsk-2,Russia3,41,47,24,71,40,,8669
2000-01,Russia U18,WJC-18,6,4,3,7,0,4,8669
2000-01,Red Deer Rebels,WHL,72,7,28,35,113,45,9516
2000-01,Red Deer Rebels,M-Cup,4,0,0,0,0,-2,9516
2000-01,Saskatoon Blades,WHL,5,0,5,5,4,-1,14513
2000-01,Ohio State Univ.,NCAA,33,17,18,35,80,10,9388
2000-01,USA U20,WJC-20,7,0,1,1,6,1,9388
2000-01,Seattle Thunderbirds,WHL,71,4,7,11,174,-12,11472
2000-01,Kitchener Rangers,OHL,65,42,39,81,114,-20,8810
2000-01,Spartak Moskva,Russia2,13,0,0,0,2,,9390
2000-01,Russia U18,WJC-18,6,2,2,4,0,5,9390
2000-01,Prince Albert Raiders,WHL,71,22,28,50,72,-42,12768
2000-01,Toronto St. Michael's Majors,OHL,61,7,35,42,54,24,8569
2000-01,Canada U20,WJC-20,7,0,2,2,6,3,8569
2000-01,Red Deer Rebels,WHL,69,55,46,101,202,46,8805
2000-01,Red Deer Rebels,M-Cup,4,2,4,6,4,-4,8805
2000-01,Swift Current Broncos,WHL,68,38,54,92,51,22,11015
2000-01,Minnesota State Univ. (Mankato),NCAA,37,11,14,25,92,,10322
2000-01,HC Litvinov,Czech,52,12,26,38,52,14,11485
2000-01,Czech Republic,EHT,4,0,0,0,2,1,11485
2000-01,Czech Republic,WC,9,0,0,0,6,8,11485
2000-01,Czech Republic (all),International,18,1,2,3,12,,11485
2000-01,SKA St. Petersburg,Russia,36,2,4,6,20,,8691
2000-01,Russia U18,WJC-18,6,1,4,5,18,9,8691
2000-01,Avangard Omsk-2,Russia3,41,19,28,47,69,,9569
2000-01,Russia U18,WJC-18,6,2,3,5,10,4,9569
2000-01,HC Kosice U20,Slovakia U20,3,1,1,2,6,,8420
2000-01,HC Kosice,Slovakia,43,5,5,10,28,,8420
2000-01,Slovakia U18,WJC-18,6,0,1,1,16,1,8420
2000-01,Slovakia U20,WJC-20,7,1,1,2,8,-1,8420
2000-01,Red Deer Rebels,WHL,72,12,37,49,181,29,11735
2000-01,Red Deer Rebels,M-Cup,4,1,2,3,11,1,11735
2000-01,Prince Albert Raiders,WHL,70,16,33,49,24,-28,9644
2000-01,Slovakia U18,WJC-18,6,2,3,5,4,0,9644
2000-01,Tri-City Americans,WHL,39,13,13,26,36,0,8053
2000-01,Lethbridge Hurricanes,WHL,21,8,6,14,23,3,8053
2000-01,Kingston Frontenacs,OHL,52,40,37,77,44,21,9525
2000-01,Canada U20,WJC-20,7,2,2,4,0,5,9525
2000-01,THK Tver,Russia2,38,10,5,15,10,,9573
2000-01,Russia U18,WJC-18,6,3,0,3,6,5,9573
2000-01,JYP U20,Jr. A SM-liiga,1,1,0,1,2,,2715
2000-01,JYP,Liiga,47,3,6,9,59,-3,2715
2000-01,Finland U20,WJC-20,7,0,0,0,6,1,2715
2000-01,Finland U20 (all),International-Jr,16,2,1,3,12,,2715
2000-01,Univ. of Michigan,NCAA,42,29,32,61,24,28,9104
2000-01,Canada U20,WJC-20,7,4,2,6,2,-1,9104
2000-01,North Bay Centennials,OHL,66,22,32,54,64,-1,8855
2000-01,HIFK,Liiga,56,32,28,60,51,10,10863
2000-01,Czech Republic,EHT,3,0,0,0,2,-2,10863
2000-01,Czech Republic (all),International,7,1,0,1,2,0,10863
2000-01,Kelowna Rockets,WHL,65,38,28,66,94,-1,14450
2000-01,St. Sebastian's School,USHS-Prep,30,11,20,31,37,,10323
2000-01,Shawinigan Cataractes,QMJHL,71,46,67,113,24,42,8809
2000-01,Brampton Battalion,OHL,66,30,19,49,61,11,9517
2000-01,Canada U18,Nations Cup,3,1,0,1,2,,9517
2000-01,Moose Jaw Warriors,WHL,70,8,54,62,118,2,8902
2000-01,Spokane Chiefs,WHL,33,13,14,27,63,8,10197
2000-01,Russia U18,WJC-18,6,0,2,2,4,9,15250
2000-01,Hammarby IF,Allsvenskan,37,5,13,18,40,26,463
2000-01,Sweden U20,WJC-20,6,0,2,2,4,0,463
2000-01,CSK VVS Samara,Russia2,39,10,10,20,88,,9566
2000-01,Russia U18,WJC-18,6,6,4,10,8,11,9566
2000-01,Rimouski Océanic,QMJHL,64,13,50,63,198,-17,10219
2000-01,Slovakia U20,WJC-20,7,0,0,0,2,0,10219
2000-01,Ottawa 67's,OHL,68,7,32,39,59,0,9514
2000-01,Ottawa 67's,M-Cup,4,0,0,0,2,0,9514
2000-01,Sudbury Wolves,OHL,67,33,45,78,88,25,9559
2000-01,Baie-Comeau Drakkar,QMJHL,61,24,38,62,33,16,12671
2000-01,Prince Albert Raiders,WHL,61,2,6,8,280,-22,11715
2000-01,Red Deer Rebels,WHL,70,24,13,37,89,23,16663
2000-01,Red Deer Rebels,M-Cup,4,2,0,2,0,-1,16663
2000-01,AIK J20,SuperElit,21,6,13,19,10,,27
2000-01,AIK,SHL,0,0,0,0,0,,27
2000-01,Sweden U18,WJC-18,6,1,4,5,0,1,27
2000-01,Sweden U18 (all),International-Jr,16,4,9,13,14,,27
2000-01,HC Kladno U20,Czech U20,9,6,4,10,4,9,8668
2000-01,HC Kladno,Czech,47,9,9,18,24,-5,8668
2000-01,BK Mlada Boleslav,Czech3,4,5,5,10,4,,8668
2000-01,Czech Republic U20,WJC-20,7,1,1,2,6,0,8668
2000-01,Czech Republic U20 (all),International-Jr,7,1,1,2,6,0,8668
2000-01,Czech Republic (all),International,2,0,0,0,4,,8668
2000-01,Oshawa Generals,OHL,52,15,23,38,21,-7,8361
2000-01,Spokane Chiefs,WHL,51,2,15,17,76,-1,15111
2000-01,Kristall Saratov,Russia2,39,11,6,17,32,,19120
2000-01,Ilves U20,Jr. A SM-liiga,31,8,12,20,74,,3595
2000-01,Ilves,Liiga,14,0,1,1,10,0,3595
2000-01,Austria U18,WJC-18 D1,5,5,3,8,10,4,3595
2000-01,Austria U20,WJC-20 D1,5,5,2,7,10,-1,3595
2000-01,Austria,OGQ,3,1,0,1,0,-1,3595
2000-01,Austria,WC,6,0,0,0,0,-3,3595
2000-01,Seattle Thunderbirds,WHL,42,10,9,19,161,-8,28068
2000-01,Davos U20,Elite Jr. A,27,6,7,13,44,,12854
2000-01,HC Davos,NLA,7,0,0,0,6,,12854
2000-01,SC Herisau,NLB,3,0,0,0,16,,12854
2000-01,Switzerland U18,WJC-18,7,2,2,4,34,0,12854
2000-01,Switzerland U20,WJC-20,7,0,1,1,4,-2,12854
2000-01,Regina Pats,WHL,72,28,16,44,183,0,8956
2000-01,Regina Pats,M-Cup,5,3,2,5,27,1,8956
2000-01,Univ. of Notre Dame,NCAA,30,2,5,7,106,-8,9391
2000-01,Brampton Battalion,OHL,53,4,15,19,112,4,9522
2000-01,Canada U20,WJC-20,7,0,0,0,2,1,9522
2000-01,Kärpät U18,Jr. B SM-sarja,25,22,12,34,49,,3221
2000-01,Kärpät U20,Jr. A SM-liiga,17,4,4,8,12,,3221
2000-01,Kärpät,Liiga,0,0,0,0,0,0,3221
2000-01,Finland U18,WJC-18,6,1,2,3,18,2,3221
2000-01,Finland U18 (all),International-Jr,15,5,2,7,28,,3221
2000-01,Harvard Univ.,NCAA,21,0,2,2,37,,15466
2000-01,Rimouski Océanic,QMJHL,64,12,41,53,128,-16,10233
2000-01,Toronto St. Michael's Majors,OHL,58,5,15,20,134,4,10700
2000-01,Brynäs IF J20,SuperElit,20,6,6,12,58,,58
2000-01,Brynäs IF,SHL,6,0,0,0,0,-2,58
2000-01,Sweden U19 (all),International-Jr,3,0,0,0,2,,58
2000-01,Sherbrooke Castors,QMJHL,68,33,51,84,159,-11,19384
2000-01,Calgary Hitmen,WHL,48,15,10,25,33,5,11490
2000-01,Chilliwack Chiefs,BCHL,59,34,84,118,65,,10412
2000-01,Merrimack College,NCAA,38,17,25,42,22,-7,10333
2000-01,Val-d'Or Foreurs,QMJHL,68,48,67,115,90,35,8839
2000-01,Val-d'Or Foreurs,M-Cup,5,3,3,6,6,8,8839
2000-01,Vityaz Podolsk,Russia,24,0,1,1,14,,8635
2000-01,Russia U18,WJC-18,6,1,1,2,4,1,8635
2000-01,Univ. of Vermont,NCAA,34,12,15,27,36,,8880
2000-01,Val-d'Or Foreurs,QMJHL,70,8,17,25,124,16,12044
2000-01,Val-d'Or Foreurs,M-Cup,5,1,2,3,12,9,12044
2000-01,London Knights,OHL,66,21,16,37,218,-18,10874
2000-01,Brandon Wheat Kings,WHL,60,20,28,48,172,1,9515
2000-01,Miami Univ. (Ohio),NCAA,32,0,1,1,48,-2,11498
2000-01,Kingston Frontenacs,OHL,68,29,27,56,39,16,15108
2000-01,HPK,Liiga,54,18,31,49,48,-7,2710
2000-01,Finland,WC,9,2,6,8,8,6,2710
2000-01,TPS,Liiga,56,27,33,60,24,19,2095
2000-01,Finland,WC,9,2,6,8,2,3,2095
2000-01,Rimouski Océanic,QMJHL,62,7,19,26,155,-34,58592
2000-01,Spartak Moskva,Russia2,10,0,0,0,2,,13964
2000-01,Russia U18,WJC-18,6,0,3,3,10,3,13964
2000-01,Krefeld Pinguine,DEL,58,3,11,14,73,0,8581
2000-01,EV Duisburg,Germany3,6,1,2,3,12,,8581
2000-01,Germany U20,WJC-20 D1,5,1,3,4,6,6,8581
2000-01,Germany (all),International,8,0,1,1,8,,8581
2000-01,Jokerit U18,Jr. B SM-sarja,10,4,9,13,4,,3215
2000-01,Jokerit U20,Jr. A SM-liiga,39,7,8,15,10,,3215
2000-01,Finland U18,WJC-18,6,1,0,1,8,0,3215
2000-01,Finland U18 (all),International-Jr,18,5,3,8,12,,3215
2000-01,TPS,Liiga,56,5,14,19,71,13,2701
2000-01,Burnaby Bulldogs,BCHL,50,46,52,98,84,,13493
2000-01,Omaha Lancers,USHL,55,10,11,21,77,,9450
2000-01,Metallurg Magnitogorsk,Russia,31,3,5,8,10,,18850
2000-01,Amur Khabarovsk,Russia,1,0,0,0,0,,19108
2000-01,Amur Khabarovsk-2,Russia3,3,0,0,0,8,,19108
2000-01,Camrose Kodiaks,AJHL,55,8,16,24,81,,13419
2000-01,Camrose Kodiaks,RBC Cup,3,0,1,1,4,,13419
2000-01,Metallurg Magnitogorsk,Russia,40,2,3,5,34,,20508
2000-01,HK Poprad U20,Slovakia U20,0,0,0,0,0,,8681
2000-01,HK SKP Poprad,Slovakia,53,22,28,50,30,3,8681
2000-01,Slovakia U20,WJC-20,7,1,3,4,6,0,8681
2000-01,North Bay Centennials,OHL,62,17,61,78,175,4,58597
2000-01,Muskegon Fury,UHL,0,0,0,0,0,,58597
2000-01,London Knights,OHL,67,23,25,48,93,-18,2489
2000-01,Avangard Omsk,Russia,26,2,10,12,32,9,9560
2000-01,Russia U20,WJC-20,7,2,2,4,35,2,9560
2000-01,Spokane Chiefs,WHL,53,20,21,41,26,-2,53959
2000-01,HC Sparta Praha U20,Czech U20,27,9,10,19,30,18,57296
2000-01,HC Sparta Praha,Czech,1,0,0,0,0,,57296
2000-01,Czech Republic U18,WJC-18,7,2,0,2,2,-1,57296
2000-01,Czech Republic U18 (all),International-Jr,25,2,0,2,2,,57296
2000-01,München Barons,DEL,55,6,3,9,80,0,8877
2000-01,Germany U20,WJC-20 D1,5,1,1,2,10,5,8877
2000-01,Germany,OGQ,3,0,0,0,0,-2,8877
2000-01,Germany,WC,1,0,0,0,0,0,8877
2000-01,Germany (all),International,9,0,0,0,2,,8877
2000-01,Krylia Sovetov Moskva,Russia2,11,0,4,4,4,,18987
2000-01,HC Zlin U20,Czech U20,43,3,15,18,30,7,8421
2000-01,HC Zlin,Czech,8,0,2,2,0,-3,8421
2000-01,Guelph Storm,OHL,65,25,27,52,129,8,15719
2000-01,Boston College,NCAA,41,13,26,39,12,6,8504
2000-01,Belleville Bulls,OHL,68,35,83,118,24,47,8818
2000-01,Colorado College,NCAA,41,2,7,9,26,,11570
2000-01,Baie-Comeau Drakkar,QMJHL,68,10,14,24,46,-8,8911
2000-01,Québec Remparts,QMJHL,71,24,43,67,32,-9,13483
2000-01,HC Liberec U20,Czech U20,43,25,20,45,52,15,8584
2000-01,Czech Republic U18,WJC-18,7,1,1,2,2,-4,8584
2000-01,Czech Republic U18 (all),International-Jr,18,-,-,-,-,,8584
2000-01,Plymouth Whalers,OHL,60,12,36,48,98,22,12563
2000-01,Blues U18,Jr. B SM-sarja,10,3,6,9,2,,3211
2000-01,Blues U20,Jr. A SM-liiga,36,6,6,12,16,,3211
2000-01,Finland U18 (all),International-Jr,18,6,5,11,12,,3211
2000-01,Finland U18,WJC-18,6,2,2,4,4,3,3211
2000-01,Boston Univ.,NCAA,35,4,5,9,4,-1,13649
2000-01,Belleville Bulls,OHL,66,7,16,23,135,-6,8975
2000-01,Westminster Prep.,USHS-Prep,-,-,-,-,-,,53007
2000-01,KalPa U18,Jr. B SM-sarja,4,1,4,5,10,,3193
2000-01,KalPa U20,Jr. A SM-liiga,38,6,7,13,22,,3193
2000-01,KalPa,Suomi-sarja,1,0,1,1,0,,3193
2000-01,KalPa,Suomi-sarja,-,-,-,-,-,,3193
2000-01,Finland U18,WJC-18,6,0,2,2,2,2,3193
2000-01,Finland U18 (all),International-Jr,12,1,3,4,4,,3193
2000-01,Brandon Wheat Kings,WHL,64,22,16,38,73,-12,54842
2000-01,Des Moines Buccaneers,USHL,56,13,40,53,58,,52471
2000-01,Jää-Ahmat U20,Jr. A I-divisioona,9,3,4,7,41,,2699
2000-01,Ahmat Hyvinkää,Mestis,41,3,9,12,66,-4,2699
2000-01,Bowling Green State Univ.,NCAA,35,4,9,13,90,0,9682
2000-01,Tappara,Liiga,53,6,14,20,32,7,2561
2000-01,Finland U20,WJC-20,7,1,4,5,6,8,2561
2000-01,Finland U20 (all),International-Jr,16,4,4,8,20,,2561
2000-01,Breck School,USHS-MN,-,-,-,-,-,,12079
2000-01,HC Ceské Budejovice U20,Czech U20,31,9,14,23,37,1,22961
2000-01,HC Ceske Budejovice,Czech,8,1,0,1,2,0,22961
2000-01,KLH Jindrichuv Hradec,Czech3,0,0,0,0,0,,22961
2000-01,Czech Republic U20 (all),International-Jr,4,-,-,-,-,,22961
2000-01,Lincoln Stars,USHL,54,12,24,36,134,,14327
2000-01,Färjestad BK J18,J18 Allsvenskan,1,1,0,1,2,,30
2000-01,Färjestad BK J20,SuperElit,13,5,8,13,83,,30
2000-01,Färjestad BK,SHL,1,0,0,0,0,0,30
2000-01,Sweden U18,WJC-18,6,3,4,7,26,2,30
2000-01,Sweden U18 (all),International-Jr,16,9,9,18,44,,30
2000-01,Spartak Moskva,Russia2,21,6,3,9,4,,15678
2000-01,Russia U18,WJC-18,6,1,4,5,0,2,15678
2000-01,Sherbrooke Castors,QMJHL,65,3,15,18,143,-17,18716
2000-01,Russia U18,WJC-18,6,0,1,1,4,2,18716
2000-01,SC Riessersee,Germany2,39,1,2,3,12,,21472
2000-01,SC Riessersee U18,DNL,11,1,7,8,24,,21472
2000-01,Germany U18,WJC-18,6,2,0,2,18,6,21472
2000-01,Djurgårdens IF,SHL,48,10,12,22,46,6,753
2000-01,Sweden,WC,9,4,0,4,4,3,753
2000-01,Sweden (all),International,25,11,5,16,10,,753
2000-01,SKA St. Petersburg,Russia,34,6,5,11,22,,9563
2000-01,Russia U18,WJC-18,6,2,7,9,8,8,9563
2000-01,Drummondville Voltigeurs,QMJHL,62,10,36,46,100,-8,18670
2000-01,HC Vsetin U20,Czech U20,45,9,12,21,110,29,52122
2000-01,CSK VVS Samara,Russia2,18,2,1,3,24,,9384
2000-01,Lada Togliatti-2,Russia3,-,-,-,-,-,,9384
2000-01,Seattle Thunderbirds,WHL,72,25,31,56,45,5,12476
2000-01,MHC Martin,Slovakia,44,8,5,13,62,,15839
2000-01,Sarnia Sting,OHL,49,31,44,75,48,-1,11761
2000-01,Adler Mannheim,DEL,55,2,5,7,6,10,8590
2000-01,Mannheimer ERC II,Germany4,9,3,8,11,20,,8590
2000-01,Germany U20,WJC-20 D1,5,1,3,4,2,5,8590
2000-01,Germany,WC,7,0,1,1,2,-1,8590
2000-01,Germany (all),International,9,0,2,2,4,,8590
2000-01,Langley Hornets,BCHL,59,30,61,91,47,,13562
2000-01,Avangard Omsk-2,Russia3,-,-,-,-,-,,16731
2000-01,Russia U18,WJC-18,6,2,3,5,0,3,16731
2000-01,Moncton Gagnon Beavers,MJAHL,30,21,22,43,-,,9116
2000-01,Rimouski Océanic,QMJHL,32,15,10,25,43,-6,9116
2000-01,HIFK,Liiga,51,12,25,37,146,12,3633
2000-01,Czech Republic,EHT,3,0,0,0,16,-3,3633
2000-01,Czech Republic (all),International,3,0,0,0,16,,3633
2000-01,Metallurg Magnitogorsk,Russia,44,16,31,47,80,,34994
2000-01,Russia,WC,7,3,4,7,0,0,34994
2000-01,Waterloo Black Hawks,USHL,54,4,10,14,128,,9062
2000-01,Sioux City Musketeers,USHL,51,18,26,44,65,,14670
2000-01,Phillips Exeter Academy,USHS-Prep,31,42,40,82,34,,10632
2000-01,HC Ytong Brno U20,Czech U20,26,10,11,21,22,-2,58785
2000-01,HC Ytong Brno,Czech2,20,4,4,8,4,-8,58785
2000-01,HC Ytong Brno,Czech2 Q,0,0,0,0,0,,58785
2000-01,UMass (Amherst),NCAA,31,6,4,10,18,-4,31511
2000-01,Västra Frölunda HC J18,J18 Allsvenskan,1,0,0,0,0,,578
2000-01,Västra Frölunda HC J20,SuperElit,15,1,0,1,4,,578
2000-01,Sweden U18 (all),International-Jr,3,0,0,0,0,,578
2000-01,HC Karlovy Vary U20,Czech U20,30,6,5,11,14,-4,9606
2000-01,HC Karlovy Vary,Czech,8,1,0,1,4,2,9606
2000-01,HC Most,Czech3,1,0,0,0,0,,9606
2000-01,Czech Republic U18,WJC-18,7,2,3,5,0,-4,9606
2000-01,Czech Republic U18 (all),International-Jr,12,-,-,-,-,,9606
2000-01,Czech Republic U20 (all),International-Jr,4,-,-,-,-,,9606
2000-01,Sioux City Musketeers,USHL,52,1,1,2,252,,21394
2000-01,Medicine Hat Tigers,WHL,62,3,10,13,279,0,59113
2000-01,HC Slavia Praha U20,Czech U20,44,10,8,18,24,-2,57300
2000-01,Czech Republic U18,WJC-18,7,0,2,2,6,-2,57300
2000-01,Czech Republic U18 (all),International-Jr,22,-,-,-,-,,57300
2000-01,Kärpät U18,Jr. B SM-sarja,1,2,1,3,0,,2716
2000-01,Kärpät U20,Jr. A SM-liiga,48,18,31,49,69,,2716
2000-01,Finland U18,WJC-18,6,2,0,2,2,-1,2716
2000-01,Finland U18 (all),International-Jr,18,4,5,9,12,,2716
2000-01,Moose Jaw Warriors,WHL,71,9,21,30,28,-2,9518
2000-01,Sioux Falls Stampede,USHL,56,37,38,75,56,,59114
2000-01,Guelph Storm,OHL,67,38,38,76,53,-1,13509
2000-01,HC Liberec U20,Czech U20,31,0,3,3,36,-3,13655
2000-01,Czech Republic U18,WJC-18,7,0,0,0,6,-6,13655
2000-01,Czech Republic U18 (all),International-Jr,19,-,-,-,-,,13655
2000-01,HK Dukla Trencin,Slovakia,14,0,0,0,2,,43689
2000-01,Saskatoon Blades,WHL,70,1,8,9,116,-17,17852
2000-01,Lukko U20,Jr. A SM-liiga,16,9,15,24,6,,3182
2000-01,Lukko,Liiga,47,5,1,6,6,-5,3182
2000-01,UJK,Mestis,2,0,0,0,0,1,3182
2000-01,Finland U20,WJC-20,7,0,1,1,0,0,3182
2000-01,Finland U20 (all),International-Jr,13,0,1,1,4,,3182
2000-01,Phillips Exeter Academy,USHS-Prep,-,-,-,-,-,,59115
2000-01,Prince George Cougars,WHL,61,1,8,9,245,-9,9084
2000-01,Oshawa Generals,OHL,2,0,0,0,4,-1,11726
2000-01,Guelph Storm,OHL,50,0,2,2,59,1,11726
2000-01,Lugano U20,Elite Jr. A,35,22,30,52,152,,12696
2000-01,HC Lugano,NLA,13,1,0,1,0,,12696
2000-01,HC Sierre,NLB,2,0,0,0,0,,12696
2000-01,Switzerland U18,WJC-18,7,2,2,4,12,0,12696
2000-01,Ilves U18,Jr. B SM-sarja,5,1,1,2,16,,3212
2000-01,Ilves U20,Jr. A SM-liiga,41,4,1,5,30,,3212
2000-01,Finland U18,WJC-18,6,2,0,2,2,1,3212
2000-01,Finland U18 (all),International-Jr,12,2,0,2,2,,3212
2000-01,Québec Remparts,QMJHL,70,12,35,47,121,-30,15838
2000-01,Saskatoon Blades,WHL,72,38,40,78,40,-34,15320
2000-01,Hartford Wolf Pack,AHL,7,1,0,1,0,-1,15320
2000-01,Baie-Comeau Drakkar,QMJHL,65,0,4,4,408,-1,26590
2000-01,Tri-City Americans,WHL,72,5,12,17,113,1,12836
2000-01,Halifax Mooseheads,QMJHL,72,48,41,89,78,13,9920
2000-01,Prince George Cougars,WHL,59,9,14,23,169,-15,14409
2000-01,Elemash Elektrostal,Russia2,25,0,3,3,6,-6,13528
2000-01,Barrie Colts,OHL,60,6,18,24,114,9,8038
2000-01,Czech Republic U18,WJC-18,7,0,0,0,20,-4,8038
2000-01,Czech Republic U18 (all),International-Jr,7,0,0,0,20,-4,8038
2000-01,Harvard Univ.,NCAA,33,4,4,8,28,,14824
2000-01,St. Louis Sting,NAHL,9,2,2,4,2,,8959
2000-01,Cedar Rapids Roughriders,USHL,51,20,18,38,14,,8959
2000-01,Moncton Wildcats,QMJHL,44,11,38,49,147,-9,1015
2000-01,Victoriaville Tigres,QMJHL,24,3,16,19,112,31,1015
2000-01,Ottawa 67's,OHL,65,1,14,15,49,11,15947
2000-01,Ottawa 67's,M-Cup,4,0,1,1,10,-1,15947
2000-01,Lincoln Stars,USHL,55,47,33,80,22,,10260
2000-01,Brynäs IF J20,SuperElit,1,1,0,1,0,,59
2000-01,Brynäs IF,SHL,50,15,11,26,20,-10,59
2000-01,Great Falls Americans,AWHL,54,13,23,36,93,,18
2000-01,Tingsryds AIF,Allsvenskan,38,8,5,13,24,2,936
2000-01,Sweden U19 (all),International-Jr,7,0,3,3,6,,936
2000-01,Kootenay Ice,WHL,39,23,18,41,47,17,8604
2000-01,Québec Remparts,QMJHL,41,10,10,20,317,-2,48428
2000-01,Victoria Salsa,BCHL,57,34,34,68,196,,14109
2000-01,Prince Albert Raiders,WHL,68,8,8,16,193,-26,17967
2000-01,Des Moines Buccaneers,USHL,56,7,11,18,53,,59117
2000-01,Huddinge IK J18,J18 Allsvenskan,7,1,3,4,30,,643
2000-01,Huddinge IK J20,SuperElit,7,0,1,1,14,,643
2000-01,Sweden U18,WJC-18,6,0,0,0,6,2,643
2000-01,Kindersley Klippers,SJHL,68,18,24,42,123,,10415
2000-01,Brampton Battalion,OHL,52,5,10,15,51,-1,17972
2000-01,Univ. of Nebraska-Omaha,NCAA,30,2,13,15,14,,16584
2000-01,Medicine Hat Tigers,WHL,65,19,39,58,125,-26,9055
2000-01,Seattle Thunderbirds,WHL,67,13,20,33,109,-3,13243
2000-01,Mora IK J18,J18 Allsvenskan,7,3,4,7,12,,321
2000-01,Mora IK J20,SuperElit,15,6,4,10,40,,321
2000-01,Mora IK,Allsvenskan,12,1,0,1,4,-5,321
2000-01,Sweden U18,WJC-18,6,1,2,3,10,3,321
2000-01,Sweden U18 (all),International-Jr,16,2,2,4,20,,321
2000-01,Halifax Mooseheads,QMJHL,68,0,5,5,56,-3,8677
2000-01,Slovakia U18,WJC-18,6,0,0,0,6,-2,8677
2000-01,Selkirk Steelers,MJHL,64,46,56,102,72,,11561
2000-01,Toronto St. Michael's Majors,OHL,61,23,33,56,37,16,13648
2000-01,Ohio State Univ.,NCAA,10,0,1,1,2,1,8030
2000-01,Ottawa 67's,OHL,35,9,10,19,22,4,8030
2000-01,Ottawa 67's,M-Cup,4,0,0,0,2,-2,8030
2000-01,Neftekhimik Nizhnekamsk,Russia,24,0,2,2,12,,57088
2000-01,Moose Jaw Warriors,WHL,72,11,25,36,115,5,8610
2000-01,HC Vsetin U20,Czech U20,45,27,15,42,52,30,38457
2000-01,Jokerit,Liiga,52,2,8,10,98,26,868
2000-01,Princeton Univ.,NCAA,30,4,5,9,12,,43119
2000-01,SaiPa U20,Jr. A SM-liiga,1,1,1,2,0,,3216
2000-01,SaiPa,Liiga,42,0,4,4,8,-7,3216
2000-01,Finland U20,WJC-20,7,4,3,7,0,4,3216
2000-01,Finland U20 (all),International-Jr,20,8,8,16,10,,3216
2000-01,Val-d'Or Foreurs,QMJHL,38,3,4,7,57,1,26581
2000-01,Montréal Rocket,QMJHL,27,3,8,11,37,0,26581
2000-01,HC Zlin,Czech,52,18,31,49,105,-3,8609
2000-01,Czech Republic,EHT,10,2,2,4,12,,8609
2000-01,Czech Republic,WC,9,2,6,8,4,9,8609
2000-01,Czech Republic (all),International,29,7,8,15,26,15,8609
2000-01,Slovakia U18,WJC-18,4,1,1,2,2,2,53141
2000-01,Merrimack College,NCAA,33,6,18,24,22,,13427
2000-01,Boston Univ.,NCAA,35,5,5,10,20,2,9448
2000-01,Khimik Voskresensk,Russia2,4,0,0,0,0,,59119
2000-01,Ak Bars Kazan,Russia,33,3,7,10,24,,17971
2000-01,Neftekhimik Nizhnekamsk,Russia,35,7,10,17,54,,59127
2000-01,Michigan Tech,NCAA,0,0,0,0,0,,9393
2000-01,HC Trinec,Czech,46,11,16,27,24,12,18146
2000-01,Czech Republic,EHT,6,0,0,0,4,0,18146
2000-01,Czech Republic (all),International,6,0,2,2,4,,18146
2000-01,HK Dukla Trencin U20,Slovakia U20,35,3,6,9,16,,53321
2000-01,Moncton Wildcats,QMJHL,45,10,19,29,38,-2,9520
2000-01,Chicoutimi Saguenéens,QMJHL,28,10,13,23,14,-7,9520
2000-01,Hull Olympiques,QMJHL,72,8,14,22,31,-17,59120
2000-01,HC Trinec,Czech,31,8,12,20,20,,7523
2000-01,HC Slavia Praha,Czech,19,9,9,18,8,2,7523
2000-01,Czech Republic,EHT,3,2,0,2,0,3,7523
2000-01,Czech Republic,WC,9,6,1,7,4,9,7523
2000-01,Czech Republic (all),International,20,11,2,13,8,14,7523
2000-01,Ilves,Liiga,54,2,14,16,99,0,8630
2000-01,Univ. of Vermont,NCAA,34,8,23,31,14,,14638
2000-01,Lukko U20,Jr. A SM-liiga,42,22,22,44,26,,7960
2000-01,Latvia U20,WJC-20 D1,5,1,4,5,2,-5,7960
2000-01,Latvia (all),International,4,0,1,1,0,,7960
2000-01,Regina Pats,WHL,64,10,25,35,40,7,15331
2000-01,Regina Pats,M-Cup,5,0,0,0,2,-2,15331
2000-01,Kärpät,Liiga,54,6,9,15,58,-15,3247
2000-01,HC Pardubice,Czech,47,10,13,23,75,22,10860
2000-01,Czech Republic,EHT,6,0,1,1,4,5,10860
2000-01,Czech Republic (all),International,10,0,1,1,4,6,10860
2000-01,Kloten U20,Elite Jr. A,4,3,1,4,8,,12678
2000-01,Kloten Flyers,NLA,27,0,2,2,17,,12678
2000-01,Switzerland U18,WJC-18,7,2,3,5,10,4,12678
2000-01,Switzerland U20,WJC-20,7,0,0,0,10,0,12678
2000-01,North Bay Centennials,OHL,58,2,27,29,85,-17,59121
2000-01,St. John's Maple Leafs,AHL,2,0,0,0,0,0,59121
2000-01,Georgetown Raiders,OPJHL,47,45,38,83,-,,17970
2000-01,Red Deer Rebels,WHL,44,1,4,5,30,-3,4344
2000-01,Red Deer Rebels,M-Cup,4,0,0,0,2,1,4344
2000-01,Lethbridge Hurricanes,WHL,11,0,0,0,49,-2,17969
2000-01,Tri-City Americans,WHL,56,1,6,7,170,5,17969
2000-01,Metallurg Novokuznetsk,Russia,44,7,10,17,36,,17968
2000-01,Molot-Prikamie Perm,Russia,5,0,0,0,0,,18140
2000-01,Molot-Prikamie Perm-2,Russia3,4,0,1,1,0,,18140
2000-01,Peterborough Petes,OHL,61,36,35,71,14,32,6364
2000-01,Slovenia U20,WJC-20 D2,4,5,1,6,0,3,6364
2000-01,Slovenia,WC D1,5,2,3,5,2,7,6364
2000-01,Mörrums GoIS,Allsvenskan,27,0,1,1,12,-5,882
2000-01,Sweden U18,WJC-18,6,1,1,2,14,2,882
2000-01,Sweden U18 (all),International-Jr,16,1,1,2,24,,882
2000-01,HC Slavia Praha,Czech,50,16,24,40,24,7,10847
2000-01,Czech Republic,EHT,10,2,4,6,4,8,10847
2000-01,Czech Republic (all),International,14,3,4,7,6,8,10847
2000-01,HC Slavia Praha U20,Czech U20,5,2,2,4,4,-1,15842
2000-01,HC Slavia Praha,Czech,37,3,9,12,8,4,15842
2000-01,HC Berounsti Medvedi,Czech2,8,0,2,2,2,-5,15842
2000-01,BK Mlada Boleslav,Czech2 Q,-,-,-,-,-,,15842
2000-01,Czech Republic U20,WJC-20,6,1,1,2,4,4,15842
2000-01,Czech Republic U20 (all),International-Jr,14,1,1,2,4,4,15842
2000-01,Ilves,Liiga,56,10,18,28,16,3,2665
2000-01,Lukko U20,Jr. A SM-liiga,41,6,10,16,34,,3233
2000-01,Finland U18,WJC-18,6,1,2,3,2,3,3233
2000-01,Finland U18 (all),International-Jr,15,1,3,4,12,,3233
2000-01,RPI (Rensselaer Polytech. Inst.),NCAA,21,0,3,3,14,,74628
2000-01,Södertälje SK J20,SuperElit,14,1,0,1,16,,679
2001-02,London Knights,OHL,54,32,40,72,88,-16,3658
2001-02,Canada U20,WJC-20,7,1,2,3,2,3,3658
2001-02,Canada U18,Nations Cup,5,5,5,10,35,,3658
2001-02,Medicine Hat Tigers,WHL,61,11,50,61,42,-3,3659
2001-02,Canada U20,WJC-20,7,0,2,2,10,11,3659
2001-02,Kärpät U20,Jr. A SM-liiga,0,0,0,0,0,,2697
2001-02,Kärpät,Liiga,49,4,15,19,65,2,2697
2001-02,Finland U20,WJC-20,7,1,3,4,0,6,2697
2001-02,Finland U20 (all),International-Jr,19,1,6,7,16,,2697
2001-02,Boston Univ.,NCAA,35,4,17,21,46,15,9399
2001-02,USA U20,WJC-20,7,1,2,3,20,2,9399
2001-02,Kamloops Blazers,WHL,61,32,51,83,139,16,9512
2001-02,Canada U20,WJC-20,7,3,3,6,10,6,9512
2001-02,Medicine Hat Tigers,WHL,72,56,50,106,95,11,9001
2001-02,Chicoutimi Saguenéens,QMJHL,69,46,94,140,54,25,9086
2001-02,Canada U18,WJC-18,8,4,8,12,16,4,9086
2001-02,Sault Ste. Marie Greyhounds,OHL,60,21,42,63,32,22,8735
2001-02,Univ. of Michigan,NCAA,40,18,13,31,42,23,6669
2001-02,USA U20,WJC-20,7,0,0,0,0,0,6669
2001-02,Univ. of Minnesota,NCAA,41,10,13,23,42,,9072
2001-02,USA U20,WJC-20,7,1,1,2,4,4,9072
2001-02,Kitchener Rangers,OHL,64,19,39,58,93,24,9147
2001-02,Traktor Chelyabinsk,Russia2,46,13,8,21,52,-8,8633
2001-02,Russia U18,WJC-18,8,8,7,15,16,13,8633
2001-02,Yale Univ.,NCAA,27,14,17,31,32,,9051
2001-02,USA U20,WJC-20,7,4,2,6,6,0,9051
2001-02,Ilves U20,Jr. A SM-liiga,27,9,23,32,54,7,2714
2001-02,Ilves,Liiga,16,2,4,6,4,2,2714
2001-02,Portland Winter Hawks,WHL,70,14,50,64,111,3,9609
2001-02,Czech Republic U18,WJC-18,8,1,8,9,8,5,9609
2001-02,Czech Republic U18 (all),International-Jr,15,-,-,-,-,,9609
2001-02,Red Deer Rebels,WHL,66,22,29,51,19,20,9513
2001-02,Lokomotiv Yaroslavl,Russia,27,1,2,3,10,4,9570
2001-02,Lokomotiv Yaroslavl-2,Russia3,7,1,1,2,2,,9570
2001-02,Russia U20,WJC-20,7,1,2,3,0,3,9570
2001-02,HC Plzen U20,Czech U20,23,14,14,28,38,10,9614
2001-02,HC Plzen,Czech,20,3,0,3,10,-7,9614
2001-02,Czech Republic U18,WJC-18,8,1,2,3,6,-1,9614
2001-02,Czech Republic U18 (all),International-Jr,22,-,-,-,-,,9614
2001-02,Guelph Storm,OHL,62,27,30,57,54,-1,9510
2001-02,Guelph Storm,M-Cup,4,1,2,3,4,-2,9510
2001-02,Elemash Elektrostal,Russia2,40,7,8,15,90,-4,8655
2001-02,Elemash Elektrostal-2,Russia3,3,0,0,0,8,,8655
2001-02,Russia U18,WJC-18,8,3,3,6,10,6,8655
2001-02,Jokerit U18,Jr. B SM-sarja,0,0,0,0,0,,2708
2001-02,Jokerit U20,Jr. A SM-liiga,23,11,19,30,36,20,2708
2001-02,Jokerit,Liiga,28,2,2,4,4,1,2708
2001-02,Kiekko-Vantaa,Mestis,4,0,0,0,52,1,2708
2001-02,Finland U18,WJC-18,8,8,4,12,6,7,2708
2001-02,Finland U20,WJC-20,7,0,1,1,4,1,2708
2001-02,Finland U20 (all),International-Jr,15,1,3,4,10,,2708
2001-02,Oshawa Generals,OHL,63,14,23,37,255,-16,8825
2001-02,Canada U18,WJC-18,8,1,3,4,45,-3,8825
2001-02,Västra Frölunda HC J20,SuperElit,23,21,17,38,47,,460
2001-02,Västra Frölunda HC,SHL,26,0,3,3,14,-2,460
2001-02,Sweden U18,WJC-18,8,2,6,8,8,1,460
2001-02,Sweden U18 (all),International-Jr,21,4,12,16,16,,460
2001-02,Hull Olympiques,QMJHL,64,6,28,34,81,-5,18018
2001-02,St. Sebastian's School,USHS-Prep,31,29,29,58,26,,11912
2001-02,HV71 Blue Bulls J20,SuperElit,26,15,19,34,20,11,133
2001-02,HV71 Blue Bulls,SHL,5,0,0,0,0,-1,133
2001-02,Sweden U18,WJC-18,8,5,1,6,18,2,133
2001-02,Sweden U18 (all),International-Jr,17,9,2,11,20,,133
2001-02,Michigan State Univ.,NCAA,37,11,21,32,50,13,8562
2001-02,USA U20,WJC-20,7,1,4,5,8,1,8562
2001-02,MIF Redhawks J18,J18 Allsvenskan,0,0,0,0,0,,520
2001-02,MIF Redhawks J20,SuperElit,33,13,17,30,50,,520
2001-02,Hungary U20,WJC-20 D2,4,4,1,5,10,3,520
2001-02,Hungary,WC D1,5,1,0,1,6,-1,520
2001-02,Hungary (all),International,-,-,-,-,-,,520
2001-02,Michigan State Univ.,NCAA,34,4,10,14,24,8,14467
2001-02,HC Vsetin U20,Czech U20,8,4,7,11,47,4,9610
2001-02,HC Vsetin,Czech,44,5,3,8,79,4,9610
2001-02,SK Horacka Slavia Trebic,Czech2,1,1,0,1,2,1,9610
2001-02,Czech Republic U18,WJC-18,8,1,6,7,45,7,9610
2001-02,Czech Republic U18 (all),International-Jr,23,1,6,7,45,,9610
2001-02,Czech Republic U20 (all),International-Jr,3,0,0,0,0,,9610
2001-02,Kootenay Ice,WHL,47,32,34,66,64,8,8895
2001-02,Canada U20,WJC-20,7,2,4,6,4,6,8895
2001-02,Kootenay Ice,M-Cup,4,0,5,5,0,2,8895
2001-02,Toronto St. Michael's Majors,OHL,61,19,40,59,52,19,9508
2001-02,Boston Univ.,NCAA,38,11,15,26,68,14,9396
2001-02,Univ. of Notre Dame,NCAA,33,11,11,22,79,-7,9389
2001-02,USA U20,WJC-20,7,2,1,3,4,0,9389
2001-02,MODO Hockey J20,SuperElit,10,9,6,15,67,,229
2001-02,MODO Hockey,SHL,42,4,3,7,20,-4,229
2001-02,IF Troja-Ljungby,Allsvenskan,3,0,0,0,12,-2,229
2001-02,Sweden U19 (all),International-Jr,7,3,3,6,4,,229
2001-02,Sweden U20 (all),International-Jr,9,0,0,0,12,,229
2001-02,Färjestad BK J18,J18 Allsvenskan,2,0,0,0,2,,1347
2001-02,Färjestad BK J20,SuperElit,32,12,6,18,52,,1347
2001-02,Norway U18,WJC-18,8,5,3,8,12,2,1347
2001-02,Norway U20,WJC-20 D1,5,0,1,1,2,2,1347
2001-02,Norway U18 (all),International-Jr,3,1,2,3,6,,1347
2001-02,Norway U20 (all),International-Jr,3,0,1,1,4,,1347
2001-02,Sault Ste. Marie Greyhounds,OHL,47,9,39,48,38,17,9128
2001-02,Green Bay Gamblers,USHL,55,4,20,24,150,,9170
2001-02,HC Pardubice U20,Czech U20,36,2,3,5,28,6,15831
2001-02,HC Sumperk,Czech2,1,0,0,0,2,0,15831
2001-02,Czech Republic U18 (all),International-Jr,13,-,-,-,-,,15831
2001-02,Metallurg Magnitogorsk,Russia,46,4,13,17,18,-6,9568
2001-02,Elemash Elektrostal,Russia2,52,18,9,27,40,-8,9577
2001-02,Elemash Elektrostal-2,Russia3,4,4,5,9,2,,9577
2001-02,Russia U18,WJC-18,8,2,4,6,12,2,9577
2001-02,Avangard Omsk,Russia,41,1,5,6,34,18,9567
2001-02,HK CSKA Moskva,Russia2,39,17,12,29,8,28,9578
2001-02,HK CSKA Moskva-2,Russia3,3,3,1,4,0,,9578
2001-02,Russia U18,WJC-18,8,2,2,4,2,4,9578
2001-02,Elemash Elektrostal-2,Russia3,21,2,2,4,46,,58284
2001-02,Elemash Elektrostal,Russia2,20,0,0,0,16,-8,58284
2001-02,Winchester High,USHS-MA,6,9,8,17,14,,10631
2001-02,Univ. of Minnesota,NCAA,44,13,10,23,44,,8845
2001-02,Michigan State Univ.,NCAA,41,3,12,15,18,,9012
2001-02,Elemash Elektrostal,Russia2,33,1,1,2,42,-16,19740
2001-02,Elemash Elektrostal-2,Russia3,3,0,1,1,2,,19740
2001-02,Lokomotiv Yaroslavl-2,Russia3,14,1,0,1,10,,19740
2001-02,Russia U18,WJC-18,8,0,2,2,10,7,19740
2001-02,CSKA Moskva-2,Russia3,8,2,1,3,2,,20527
2001-02,HK CSKA Moskva,Russia2,15,2,5,7,10,8,20527
2001-02,Belleville Bulls,OHL,68,33,52,85,50,36,8889
2001-02,HC Vsetin,Czech,46,15,31,46,54,1,6665
2001-02,Bili Tygri Liberec,Czech2,1,1,2,3,0,1,6665
2001-02,HC Olomouc,Czech3,1,0,2,2,4,,6665
2001-02,Czech Republic U18,WJC-18,8,7,7,14,8,5,6665
2001-02,Czech Republic U18 (all),International-Jr,8,7,7,14,8,,6665
2001-02,Czech Republic U20,WJC-20,7,1,2,3,0,1,6665
2001-02,Czech Republic U20 (all),International-Jr,7,1,2,3,0,,6665
2001-02,Brampton Battalion,OHL,66,33,30,63,92,-4,9461
2001-02,Canada U18,WJC-18,8,0,3,3,43,0,9461
2001-02,Canada U18,Nations Cup,6,0,2,2,2,,9461
2001-02,Calgary Hitmen,WHL,70,8,32,40,85,12,9091
2001-02,Canada U18,WJC-18,5,1,0,1,8,9,9091
2001-02,Sudbury Wolves,OHL,67,14,18,32,43,-14,12230
2001-02,HC Vitkovice U20,Czech U20,44,25,25,50,16,27,9613
2001-02,HC Novy Jicin,Czech3,8,3,2,5,8,,9613
2001-02,Czech Republic U18,WJC-18,8,1,2,3,2,5,9613
2001-02,Czech Republic U18 (all),International-Jr,18,1,2,3,2,,9613
2001-02,Univ. of Michigan,NCAA,40,9,7,16,22,-2,8921
2001-02,Lillehammer,Norway,37,1,5,6,63,,3214
2001-02,Norway U18,WJC-18,8,1,1,2,18,-8,3214
2001-02,Norway U18 (all),International-Jr,3,1,0,1,6,,3214
2001-02,Norway U20,WJC-20 D1,5,1,3,4,8,0,3214
2001-02,Norway U20 (all),International-Jr,8,1,0,1,18,,3214
2001-02,Kitchener Rangers,OHL,61,28,32,60,54,19,9607
2001-02,Plymouth Whalers,OHL,65,17,36,53,105,31,9105
2001-02,Des Moines Buccaneers,USHL,44,9,38,47,25,,8539
2001-02,Kamloops Blazers,WHL,70,22,36,58,68,-4,10880
2001-02,Yale Univ.,NCAA,31,3,8,11,20,,11479
2001-02,Erie Otters,OHL,66,5,14,19,115,21,14452
2001-02,Erie Otters,M-Cup,4,0,3,3,2,0,14452
2001-02,Univ. of Minnesota,NCAA,9,1,2,3,2,,12492
2001-02,HIFK U20,Jr. A SM-liiga,24,16,17,33,60,9,3184
2001-02,Acadie-Bathurst Titan,QMJHL,66,22,48,70,83,-3,15766
2001-02,Portland Winter Hawks,WHL,61,3,10,13,125,-4,15343
2001-02,Kindersley Klippers,SJHL,62,4,21,25,125,,12041
2001-02,Michigan State Univ.,NCAA,41,4,9,13,28,,13507
2001-02,Univ. of North Dakota,NCAA,37,2,5,7,20,,9444
2001-02,VIK Hockey Ungdom,Division 1,16,2,1,3,6,,1342
2001-02,Boston College,NCAA,25,0,5,5,20,14,12033
2001-02,HC Trinec U20,Czech U20,40,10,13,23,91,11,15514
2001-02,HC Trinec,Czech,3,0,0,0,2,3,15514
2001-02,Czech Republic U18,WJC-18,8,0,1,1,6,9,15514
2001-02,Czech Republic U18 (all),International-Jr,22,-,-,-,-,,15514
2001-02,Windsor Spitfires,OHL,52,19,11,30,100,8,10836
2001-02,Plymouth Whalers,OHL,68,8,12,20,27,4,18022
2001-02,MIF Redhawks J18,J18 Allsvenskan,0,0,0,0,0,,210
2001-02,MIF Redhawks J20,SuperElit,29,15,27,42,8,,210
2001-02,MIF Redhawks,SHL,20,0,1,1,0,3,210
2001-02,Denmark U18,WJC-18 D1,3,1,2,3,0,1,210
2001-02,Denmark U20,WJC-20 D2,4,4,10,14,0,9,210
2001-02,Denmark,WC D1,5,1,1,2,0,1,210
2001-02,Hull Olympiques,QMJHL,68,5,5,10,225,-8,11489
2001-02,HK VTJ Farmakol Preov,Slovakia2,6,0,1,1,0,,13657
2001-02,Slovakia U18,WJC-18,8,1,2,3,31,-4,13657
2001-02,Victoriaville Tigres,QMJHL,66,57,73,130,70,24,8999
2001-02,Victoriaville Tigres,M-Cup,6,2,7,9,4,-1,8999
2001-02,Harvard Univ.,NCAA,3,0,1,1,8,,43127
2001-02,Hull Olympiques,QMJHL,48,16,24,40,83,-11,43127
2001-02,Kamloops Blazers,WHL,30,6,13,19,41,6,59303
2001-02,Moose Jaw Warriors,WHL,33,9,20,29,52,10,59303
2001-02,Krylia Sovetov Moskva-2,Russia3,32,12,15,27,59,,18986
2001-02,Providence College,NCAA,36,0,9,9,26,-2,15303
2001-02,Jokerit U18,Jr. B SM-sarja,1,0,1,1,0,,3197
2001-02,Jokerit U20,Jr. A SM-liiga,40,8,15,23,14,,3197
2001-02,Finland U18,WJC-18,8,4,6,10,2,5,3197
2001-02,Des Moines Buccaneers,USHL,60,24,24,48,96,,16587
2001-02,Brandon Wheat Kings,WHL,71,18,30,48,96,2,12048
2001-02,Canada U18,Nations Cup,5,1,0,1,0,,12048
2001-02,Lokomotiv Yaroslavl,Russia,44,13,21,34,57,22,21070
2001-02,Lokomotiv Yaroslavl-2,Russia3,1,0,1,1,2,,21070
2001-02,Russia,WC,9,3,2,5,2,2,21070
2001-02,Russia (all),International,12,4,2,6,2,1,21070
2001-02,Montréal Rocket,QMJHL,71,29,24,53,111,-14,9459
2001-02,Canada U18,WJC-18,8,2,2,4,2,4,9459
2001-02,HK CSKA Moskva,Russia2,2,0,1,1,0,1,12233
2001-02,HK CSKA Moskva-2,Russia3,11,1,1,2,4,,12233
2001-02,Lada Togliatti,Russia,3,0,0,0,0,0,12233
2001-02,Russia U18,WJC-18,1,0,0,0,0,0,12233
2001-02,Djurgårdens IF J20,J20 Elit,9,5,12,17,12,29,67
2001-02,Sweden U19 (all),International-Jr,3,0,1,1,0,,67
2001-02,Calgary Hitmen,WHL,71,43,40,83,122,17,14081
2001-02,HIFK U20,Jr. A SM-liiga,0,0,0,0,0,0,3195
2001-02,HIFK,Liiga,48,13,11,24,89,-2,3195
2001-02,Kootenay Ice,WHL,33,4,13,17,55,1,10983
2001-02,Swift Current Broncos,WHL,37,3,11,14,113,10,10983
2001-02,Chicoutimi Saguenéens,QMJHL,60,2,15,17,131,0,14336
2001-02,Canada U18,WJC-18,8,1,0,1,14,0,14336
2001-02,Severstal Cherepovets-2,Russia3,27,2,2,4,24,,52083
2001-02,Jokerit U18,Jr. B SM-sarja,0,0,0,0,0,,3198
2001-02,Jokerit U20,Jr. A SM-liiga,29,5,3,8,10,,3198
2001-02,Finland U18,WJC-18,7,0,0,0,6,4,3198
2001-02,HC Vitkovice U20,Czech U20,43,24,24,48,36,31,58285
2001-02,HC Vitkovice,Czech,1,0,0,0,0,-1,58285
2001-02,HC Slezan Opava,Czech2,2,0,0,0,0,-1,58285
2001-02,Czech Republic U18 (all),International-Jr,12,-,-,-,-,,58285
2001-02,Spokane Chiefs,WHL,60,6,11,17,162,-5,39661
2001-02,Blues U18,Jr. B SM-sarja,1,0,1,1,2,,3217
2001-02,Blues U20,Jr. A SM-liiga,34,14,12,26,18,11,3217
2001-02,Finland U18,WJC-18,8,2,4,6,6,5,3217
2001-02,MODO Hockey J20,SuperElit,37,26,18,44,102,,524
2001-02,MODO Hockey,SHL,3,0,0,0,0,0,524
2001-02,Sweden U19 (all),International-Jr,7,1,4,5,4,,524
2001-02,Krylia Sovetov Moskva-2,Russia3,32,24,18,42,10,,52102
2001-02,Erie Otters,OHL,68,31,32,63,72,38,19350
2001-02,Erie Otters,M-Cup,4,1,0,1,4,-3,19350
2001-02,New Hampshire Jr. Monarchs,EJHL,35,39,44,83,60,,10641
2001-02,Kamloops Blazers,WHL,69,18,23,41,77,11,15691
2001-02,Western Michigan Univ.,NCAA,38,17,17,34,26,,10409
2001-02,Windsor Spitfires,OHL,64,5,17,22,268,-7,9028
2001-02,HC Havirov U20,Czech U20,40,24,25,49,90,6,58426
2001-02,HC Havirov,Czech,7,0,0,0,0,-2,58426
2001-02,HC Sumperk,Czech2,1,0,1,1,0,-4,58426
2001-02,New York Apple Core,EJHL,86,12,26,38,69,,11562
2001-02,Latvia U20,WJC-20 D2,4,0,2,2,0,2,11562
2001-02,Färjestad BK,SHL,1,0,0,0,0,0,358
2001-02,Bofors IK,Allsvenskan,45,3,4,7,24,-9,358
2001-02,Sweden U19 (all),International-Jr,4,0,0,0,0,,358
2001-02,Sweden U20 (all),International-Jr,3,1,0,1,2,,358
2001-02,HC Havirov U20,Czech U20,41,5,11,16,75,17,43685
2001-02,HC Havirov,Czech,14,0,1,1,10,1,43685
2001-02,Czech Republic U19 (all),International-Jr,3,-,-,-,-,,43685
2001-02,Vancouver Giants,WHL,35,5,10,15,18,-13,41870
2001-02,Czech Republic U18 (all),International-Jr,2,-,-,-,-,,41870
2001-02,Moose Jaw Warriors,WHL,67,4,3,7,88,1,13405
2001-02,MIF Redhawks J18,J18 Allsvenskan,0,0,0,0,0,,518
2001-02,MIF Redhawks J20,SuperElit,36,1,4,5,70,,518
2001-02,Sweden U18,WJC-18,8,0,0,0,2,1,518
2001-02,Sweden U18 (all),International-Jr,22,1,0,1,24,,518
2001-02,Avangard Omsk,Russia,5,0,0,0,6,0,58464
2001-02,Mechel Chelyabinsk,Russia,6,1,2,3,2,2,58464
2001-02,Lada Togliatti,Russia,20,2,4,6,18,6,58464
2001-02,Green Bay Gamblers,USHL,56,4,11,15,150,,10810
2001-02,Cowichan Valley Capitals,BCHL,60,42,75,117,76,,9145
2001-02,Chicago Steel,USHL,57,13,15,28,62,,11009
2001-02,HC Pardubice U20,Czech U20,42,12,10,22,36,5,57630
2001-02,Czech Republic U18,WJC-18,7,1,2,3,4,1,57630
2001-02,Czech Republic U18 (all),International-Jr,25,-,-,-,-,,57630
2001-02,Sunne IK,Division 1,25,1,7,8,22,,1343
2001-02,Sioux City Musketeers,USHL,60,23,27,50,116,,11012
2001-02,Kärpät,Liiga,55,15,26,41,24,-7,1798
2001-02,Finland,WC,7,0,0,0,0,0,1798
2001-02,Finland (all),International,14,1,4,5,2,-2,1798
2001-02,Kärpät U20,Jr. A SM-liiga,3,0,0,0,2,1,3187
2001-02,Kärpät,Liiga,44,0,4,4,18,3,3187
2001-02,Finland U20 (all),International-Jr,17,0,0,0,2,,3187
2001-02,Finland U20,WJC-20,6,0,0,0,2,-1,3187
2001-02,Greenway High,USHS-MN,26,24,48,72,35,,13488
2001-02,Sioux Falls Stampede,USHL,13,2,4,6,0,,13488
2001-02,Kelowna Rockets,WHL,72,38,35,73,122,6,12043
2001-02,Mississauga IceDogs,OHL,20,3,10,13,14,-3,14562
2001-02,Owen Sound Attack,OHL,27,3,14,17,10,-14,14562
2001-02,Sarnia Sting,OHL,66,42,62,104,141,5,11039
2001-02,Cape Breton Screaming Eagles,QMJHL,46,4,1,5,274,2,50374
2001-02,HC Zlin U20,Czech U20,28,9,6,15,40,-3,17909
2001-02,Kloten U20,Elite Jr. A,4,1,2,3,4,,18722
2001-02,Kloten Flyers,NLA,39,1,7,8,14,,18722
2001-02,Switzerland U20,WJC-20,7,0,0,0,0,-2,18722
2001-02,Compuware Ambassadors,NAHL,53,25,24,49,69,,14852
2001-02,Brampton Battalion,OHL,68,9,35,44,148,-15,15112
2001-02,CSKA Moskva-2,Russia3,36,11,16,27,20,,19219
2001-02,Moose Jaw Warriors,WHL,72,33,29,62,31,10,10298
2001-02,Mörrums GoIS,Allsvenskan,31,0,1,1,4,-8,547
2001-02,Sweden U18 (all),International-Jr,14,2,3,5,43,,547
2001-02,Quesnel Millionaires,BCHL,60,34,50,84,33,,11530
2001-02,Miami Univ. (Ohio),NCAA,36,14,9,23,22,-12,13392
2001-02,Metalurgs Liepaja,Latvia,17,0,8,8,6,,12237
2001-02,Metalurgs Liepaja,EEHL,41,1,2,3,18,,12237
2001-02,Latvia,WC,6,0,1,1,0,-1,12237
2001-02,Latvia (all),International,13,1,2,3,2,,12237
2001-02,Shawinigan Cataractes,QMJHL,63,17,18,35,59,7,12547
2001-02,Latvia U20,WJC-20 D2,4,5,3,8,20,5,12547
2001-02,Plymouth Whalers,OHL,62,11,25,36,100,39,9407
2001-02,USA U18,WJC-18,3,1,2,3,6,5,9407
2001-02,St. Albert Saints,AJHL,53,9,19,28,62,,49470
2001-02,Topeka Scarecrows,USHL,61,37,39,76,33,,13396
2001-02,MODO Hockey J18,J18 Allsvenskan,0,0,0,0,0,,1344
2001-02,MODO Hockey J20,SuperElit,25,7,6,13,2,,1344
2001-02,Seattle Thunderbirds,WHL,41,4,25,29,25,-14,39313
2001-02,Kootenay Ice,WHL,25,2,21,23,9,12,39313
2001-02,Kootenay Ice,M-Cup,4,0,1,1,2,4,39313
2001-02,Deerfield Academy,USHS-Prep,-,-,-,-,-,,10640
2001-02,Boston Univ.,NCAA,36,8,14,22,65,-2,14458
2001-02,Spokane Chiefs,WHL,70,20,36,56,16,-4,11501
2001-02,Brandon Wheat Kings,WHL,71,17,28,45,36,-1,12018
2001-02,Barrie Colts,OHL,67,8,16,24,78,27,15610
2001-02,Cedar Rapids Roughriders,USHL,54,7,22,29,101,,12036
2001-02,Prince Albert Raiders,WHL,64,0,17,17,69,15,11584
2001-02,Ilves U18,Jr. B SM-sarja,15,6,6,12,30,,3238
2001-02,Ilves U20,Jr. A SM-liiga,5,0,1,1,4,0,3238
2001-02,Merrimack College,NCAA,31,7,17,24,48,0,9158
2001-02,Green Bay Gamblers,USHL,56,1,2,3,147,,13431
2001-02,Elemash Elektrostal,Russia2,49,6,9,15,34,-6,48284
2001-02,Russia U18,WJC-18,8,1,5,6,2,9,48284
2001-02,Vancouver Giants,WHL,67,17,16,33,83,-44,27586
2001-02,Mostovik Kurgan,Russia2,45,9,3,12,16,-18,40942
2001-02,Tappara,Liiga,53,10,18,28,74,12,2702
2001-02,Finland (all),International,10,2,2,4,4,6,2702
2001-02,Belleville Bulls,OHL,64,8,13,21,89,1,11755
2001-02,Oshawa Generals,OHL,62,0,9,9,49,-16,8866
2001-02,HC Zlin,Czech,50,25,19,44,32,11,8618
2001-02,Czech Republic,EHT,10,2,2,4,4,1,8618
2001-02,Czech Republic (all),International,14,4,3,7,4,2,8618
2001-02,Boston College,NCAA,35,7,7,14,16,-1,15023
2001-02,Tri-City Americans,WHL,69,44,59,103,73,8,6042
2001-02,Jokerit U18,Jr. B SM-sarja,1,2,0,2,12,,3242
2001-02,Jokerit U20,Jr. A SM-liiga,34,2,7,9,16,,3242
2001-02,Finland U18,WJC-18,8,1,3,4,4,5,3242
2001-02,Elemash Elektrostal-2,Russia3,4,1,0,1,6,,58479
2001-02,Elemash Elektrostal,Russia2,31,1,3,4,26,-17,58479
2001-02,Lokomotiv Yaroslavl-2,Russia3,12,3,3,6,8,,58479
2001-02,Russia U18,WJC-18,8,0,1,1,12,4,58479
2001-02,Lethbridge Hurricanes,WHL,65,10,14,24,104,-13,10200
2001-02,Swift Current Broncos,WHL,70,32,47,79,40,9,9519
2001-02,Kamloops Blazers,WHL,72,4,23,27,103,33,14038
2001-02,Colgate Univ.,NCAA,34,2,13,15,28,,12591
2001-02,HIFK U20,Jr. A SM-liiga,5,4,7,11,8,8,3179
2001-02,HIFK,Liiga,45,6,10,16,24,12,3179
2001-02,KJT,Mestis,3,1,2,3,6,0,3179
2001-02,Chicago Steel,USHL,6,2,2,4,6,,3179
2001-02,Finland U20,WJC-20,7,0,1,1,6,1,3179
2001-02,Finland U20 (all),International-Jr,11,1,1,2,10,,3179
2001-02,Bowling Green State Univ.,NCAA,37,0,2,2,40,-13,15684
2001-02,Shawinigan Cataractes,QMJHL,56,9,18,27,49,6,19744
2001-02,South Surrey Eagles,BCHL,50,15,42,57,148,,11428
2001-02,UMass (Amherst),NCAA,33,12,12,24,10,,10292
2001-02,North Bay Centennials,OHL,65,17,12,29,32,0,19591
2001-02,Victoriaville Tigres,QMJHL,72,43,64,107,105,14,41413
2001-02,Kloten U20,Elite Jr. A,9,10,7,17,4,,9640
2001-02,Kloten Flyers,NLA,25,4,4,8,8,,9640
2001-02,EHC Wetzikon,SwissDiv1,-,3,3,6,-,,9640
2001-02,Switzerland U18,WJC-18,8,5,4,9,4,-1,9640
2001-02,Switzerland U20,WJC-20,7,2,2,4,2,3,9640
2001-02,Medicine Hat Tigers,WHL,46,4,15,19,120,-24,52860
2001-02,Tri-City Americans,WHL,30,6,12,18,79,6,52860
2001-02,Djurgårdens IF J18,J18 Allsvenskan,5,9,2,11,8,,74
2001-02,Djurgårdens IF J20,J20 Elit,-,-,-,-,-,,74
2001-02,Djurgårdens IF,SHL,1,0,0,0,0,0,74
2001-02,Sweden U18,WJC-18,8,1,0,1,12,-2,74
2001-02,Sweden U18 (all),International-Jr,18,5,4,9,14,,74
2001-02,Shawinigan Cataractes,QMJHL,42,11,32,43,147,16,49474
2001-02,Cape Breton Screaming Eagles,QMJHL,26,11,9,20,120,5,49474
2001-02,Chilliwack Chiefs,BCHL,56,38,62,100,90,,11743
2001-02,Chilliwack Chiefs,RBC Cup,5,2,2,4,4,,11743
2001-02,Färjestad BK J20,SuperElit,29,1,6,7,26,,539
2001-02,Sweden U18 (all),International-Jr,15,0,3,3,24,,539
2001-02,HC Slovan Bratislava,Slovakia,50,7,13,20,22,,58482
2001-02,Slovakia,WC,3,0,0,0,0,4,58482
2001-02,Slovakia (all),International,4,0,0,0,0,0,58482
2001-02,Tappara U18,Jr. B SM-sarja,2,3,1,4,2,,3240
2001-02,Tappara U20,Jr. A SM-liiga,33,17,8,25,14,17,3240
2001-02,Finland U18,WJC-18,8,1,2,3,10,2,3240
2001-02,Peterborough Petes,OHL,39,1,1,2,127,2,58431
2001-02,Newmarket Hurricanes,OPJHL,48,11,21,32,99,,19271
2001-02,Acadie-Bathurst Titan,QMJHL,55,28,46,74,104,32,9151
2001-02,Baie-Comeau Drakkar,QMJHL,58,0,1,1,432,-4,28376
2001-02,THK Tver,Russia2,22,1,0,1,18,-10,20516
2001-02,Krylia Sovetov Moskva-2,Russia3,20,3,6,9,24,,20516
2001-02,Krylia Sovetov Moskva,Russia,13,0,1,1,14,0,20516
2001-02,Red Deer Rebels,WHL,62,16,14,30,33,22,14966
2001-02,Rochester Mustangs,USHL,14,1,6,7,65,,10404
2001-02,Topeka Scarecrows,USHL,29,4,15,19,128,,10404
2001-02,Texas Tornado,NAHL,2,0,0,0,6,,10404
2001-02,HIFK,Liiga,54,9,9,18,111,6,3230
2001-02,Västra Frölunda HC,SHL,50,14,31,45,24,15,301
2001-02,Sweden,WC,9,1,4,5,2,9,301
2001-02,Sweden (all),International,26,7,8,15,14,,301
2001-02,Ohio State Univ.,NCAA,40,12,17,29,42,,11529
2001-02,Elemash Elektrostal,Russia2,48,12,10,22,28,-13,9574
2001-02,Elemash Elektrostal-2,Russia3,5,3,6,9,4,,9574
2001-02,Russia U18,WJC-18,8,3,8,11,6,12,9574
2001-02,Kootenay Ice,WHL,72,11,23,34,119,8,14087
2001-02,Kootenay Ice,M-Cup,-,-,-,-,-,,14087
2001-02,Seattle Thunderbirds,WHL,66,6,9,15,45,-14,10320
2001-02,Green Bay Gamblers,USHL,61,15,27,42,94,,9395
2001-02,Yale Univ.,NCAA,31,9,13,22,20,,8890
2001-02,Lokomotiv Yaroslavl-2,Russia3,32,15,7,22,33,,19580
2001-02,Red Deer Rebels,WHL,71,8,19,27,33,35,9506
2001-02,Chatham Jr. Maroons,WOHL,52,51,53,104,62,,14851
2001-02,HC Plzen U20,Czech U20,38,14,35,49,46,28,22789
2001-02,HC Plzen,Czech,4,0,1,1,0,1,22789
2001-02,HC Klatovy,Czech3,6,5,3,8,0,,22789
2001-02,Czech Republic U19 (all),International-Jr,3,0,0,0,0,,22789
2001-02,Taft School,USHS-Prep,26,2,19,21,20,,19246
2001-02,Hull Olympiques,QMJHL,65,24,36,60,174,16,9511
2001-02,Chilliwack Chiefs,BCHL,54,35,37,72,92,,13440
2001-02,Chilliwack Chiefs,RBC Cup,5,2,5,7,4,,13440
2001-02,Kamloops Blazers,WHL,62,5,14,19,76,13,51175
2001-02,Krefeld Pinguine,DEL,50,30,25,55,20,5,4198
2001-02,Austria,OG,4,0,1,1,2,-1,4198
2001-02,Austria,WC,6,1,4,5,0,1,4198
2001-02,JYP U20,Jr. A SM-liiga,5,0,2,2,2,,3186
2001-02,JYP,Liiga,50,1,4,5,67,7,3186
2001-02,Finland U20,WJC-20,7,1,2,3,8,3,3186
2001-02,Finland U20 (all),International-Jr,15,1,2,3,12,,3186
2001-02,Harvard Univ.,NCAA,34,0,2,2,38,,11035
2001-02,HC Pardubice U20,Czech U20,28,38,28,66,18,1,8686
2001-02,HC Pardubice,Czech,20,1,1,2,2,-4,8686
2001-02,HC Sumperk,Czech2,8,6,4,10,0,5,8686
2001-02,Czech Republic U20,WJC-20,7,1,0,1,2,0,8686
2001-02,London Knights,OHL,65,27,42,69,141,-7,8826
2001-02,Elemash Elektrostal,Russia2,46,1,4,5,20,-21,9575
2001-02,Elemash Elektrostal-2,Russia3,6,2,3,5,6,,9575
2001-02,Russia U18,WJC-18,8,2,9,11,2,9,9575
2001-02,JYP U20,Jr. A SM-liiga,17,5,9,14,17,,3218
2001-02,JYP,Liiga,12,1,2,3,12,-1,3218
2001-02,Univ. of Michigan,NCAA,40,10,8,18,10,0,9394
2001-02,USA U20,WJC-20,7,1,0,1,2,-2,9394
2001-02,HC Slavia Praha U20,Czech U20,46,12,16,28,79,6,13658
2001-02,HC Slavia Praha,Czech,1,0,0,0,0,-1,13658
2001-02,Czech Republic U19 (all),International-Jr,3,0,0,0,0,,13658
2001-02,HC Vsetin U20,Czech U20,35,3,12,15,39,1,45900
2001-02,Czech Republic U18 (all),International-Jr,12,-,-,-,-,,45900
2001-02,TUTO Hockey U20,Jr. A SM-liiga,3,0,2,2,0,-2,3245
2001-02,TuTo Hockey,Mestis,41,11,8,19,8,0,3245
2001-02,Finland U18,WJC-18,8,2,6,8,8,7,3245
2001-02,Kitchener Rangers,OHL,65,6,25,31,63,20,58469
2001-02,Camrose Kodiaks,AJHL,55,1,10,11,110,,13447
2001-02,Hull Olympiques,QMJHL,70,8,5,13,295,-10,17119
2001-02,HC Sparta Praha,Czech,51,19,21,40,113,28,8338
2001-02,Czech Republic,EHT,3,0,0,0,4,-3,8338
2001-02,Czech Republic (all),International,3,0,0,0,4,-3,8338
2001-02,Jokerit,Liiga,43,8,14,22,30,22,561
2001-02,Finland,WC,9,2,1,3,4,2,561
2001-02,Finland (all),International,15,5,5,10,4,7,561
2001-02,Ässät U20,Jr. A I-divisioona,0,0,0,0,0,,3181
2001-02,Ässät U20,Jr. A I-divisioona,-,-,-,-,-,,3181
2001-02,Ässät,Liiga,44,0,2,2,6,-14,3181
2001-02,Finland U20,WJC-20,7,4,3,7,6,3,3181
2001-02,Finland U20 (all),International-Jr,19,8,7,15,12,,3181
2001-02,Brandon Wheat Kings,WHL,52,29,35,64,52,19,9126
2001-02,Medicine Hat Tigers,WHL,37,8,9,17,70,7,8932
2001-02,Drayton Valley Thunder,AJHL,31,9,12,21,195,,8932
2001-02,HIFK,Liiga,29,3,5,8,86,1,2693
2001-02,Elemash Elektrostal,Russia2,15,1,1,2,24,-10,59304
2001-02,Elemash Elektrostal-2,Russia3,3,0,0,0,8,,59304
2001-02,Lokomotiv Yaroslavl-2,Russia3,17,3,4,7,42,,59304
2001-02,Russia U18,WJC-18,8,2,3,5,2,6,59304
2001-02,Univ. of Notre Dame,NCAA,33,6,11,17,38,-4,8799
2001-02,Montréal Rocket,QMJHL,31,4,3,7,21,-5,14953
2001-02,Québec Remparts,QMJHL,31,0,4,4,44,3,14953
2001-02,Moncton Wildcats,QMJHL,68,3,17,20,99,-33,58471
2001-02,Timrå IK,SHL,48,8,8,16,16,-14,284
2001-02,HK CSKA Moskva,Russia2,54,34,30,64,10,56,14828
2001-02,Swift Current Broncos,WHL,65,1,4,5,226,-3,58429
2001-02,Cobourg Cougars,OPJHL,31,7,23,30,62,,39663
2001-02,Oshawa Generals,OHL,29,1,5,6,19,1,39663
2001-02,CSKA Moskva-2,Russia3,1,0,0,0,0,,12235
2001-02,Torpedo Nizhny-Novgorod-2,Russia3,34,1,6,7,54,,12235
2001-02,MIF Redhawks,SHL,41,10,7,17,14,4,204
2001-02,Sweden (all),International,6,0,2,2,12,,204
2001-02,Harvard Univ.,NCAA,30,1,3,4,6,,43125
2001-02,HC Slavia Praha U20,Czech U20,42,2,6,8,30,3,28602
2001-02,Czech Republic U18,WJC-18,8,0,0,0,4,4,28602
2001-02,Czech Republic U18 (all),International-Jr,27,-,-,-,-,,28602
2001-02,AIK J18,J18 Allsvenskan,3,0,0,0,2,,532
2001-02,AIK J20,SuperElit,20,6,7,13,18,,532
2001-02,Sweden U18 (all),International-Jr,7,1,1,2,10,,532
2001-02,Boston College,NCAA,38,6,6,12,10,-12,11718
2001-02,Västra Frölunda HC J18,J18 Allsvenskan,1,0,1,1,0,,526
2001-02,Västra Frölunda HC J20,SuperElit,37,12,20,32,37,,526
2001-02,Sweden U18,WJC-18,8,1,0,1,2,-2,526
2001-02,Sweden U18 (all),International-Jr,27,5,7,12,10,,526
2001-02,Krylia Sovetov Moskva,Russia,4,0,2,2,0,0,9576
2001-02,Krylia Sovetov Moskva-2,Russia3,26,9,19,28,44,,9576
2001-02,Russia U18,WJC-18,8,2,5,7,0,12,9576
2001-02,Molot-Prikamie Perm,Russia,51,4,7,11,64,-15,12453
2001-02,Zug U20,Elite Jr. A,1,0,1,1,0,,12648
2001-02,EV Zug,NLA,19,2,1,3,8,,12648
2001-02,EHC Basel Dragons,NLB,15,3,1,4,70,,12648
2001-02,SC Rapperswil-Jona,NLA,0,0,0,0,0,,12648
2001-02,Switzerland U20,WJC-20,7,3,3,6,29,3,12648
2001-02,St. Cloud State Univ.,NCAA,40,6,17,23,28,22,16863
2001-02,Univ. of Denver,NCAA,41,16,26,42,18,,11813
2001-02,OCN Blizzard,MJHL,55,29,51,80,37,,15844
2001-02,Kitchener Rangers,OHL,53,1,2,3,75,-7,13472
2001-02,Green Bay Gamblers,USHL,61,24,33,57,122,,10196
2001-02,Mörrums GoIS,Allsvenskan,15,0,0,0,0,-2,1345
2001-02,Kallinge/Ronneby IF,Division 2,1,0,1,1,4,,1345
2001-02,Notre Dame Hounds,SJHL,61,32,52,84,63,,15346
2001-02,Huddinge IK J20,SuperElit,1,0,0,0,0,,543
2001-02,Huddinge IK,Allsvenskan,42,4,7,11,30,-22,543
2001-02,Sweden U20,WJC-20,7,0,0,0,4,-1,543
2001-02,Sweden U20 (all),International-Jr,12,0,0,0,6,,543
2001-02,Khimik Voskresensk,Russia2,3,0,0,0,0,-2,15030
2001-02,Ohio State Univ.,NCAA,24,2,3,5,4,-2,58428
2001-02,Des Moines Buccaneers,USHL,60,7,30,37,133,,46656
2001-02,Univ. of New Hampshire,NCAA,40,20,25,45,4,,11717
2001-02,CSKA Moskva-2,Russia3,33,3,8,11,8,,52111
2001-02,Hästen Hockey J18,J18 Elit,-,-,-,-,-,,1346
2002-03,Peterborough Petes,OHL,66,39,59,98,36,20,3656
2002-03,Oshawa Generals,OHL,54,33,35,68,111,6,3657
2002-03,Canada U18,Nations Cup,5,5,2,7,43,,3657
2002-03,CSKA Moskva,Russia,44,12,12,24,34,6,8620
2002-03,Russia U20,WJC-20,6,0,1,1,2,-1,8620
2002-03,Univ. of Minnesota,NCAA,45,31,31,62,60,,8493
2002-03,Austria U20,WJC-20 D1,5,9,4,13,10,5,8493
2002-03,HC Ceske Budejovice,Czech,46,3,5,8,14,-10,8586
2002-03,HC Kladno,Czech2,0,0,0,0,0,,8586
2002-03,HC Kladno,Czech Q,-,-,-,-,-,,8586
2002-03,Czech Republic U20,WJC-20,6,2,2,4,2,-2,8586
2002-03,Czech Republic U20 (all),International-Jr,6,2,2,4,2,,8586
2002-03,Czech Republic,WC,1,0,0,0,0,0,8586
2002-03,Czech Republic (all),International,15,2,1,3,6,,8586
2002-03,U.S. National U18 Team,NAHL,9,2,5,7,12,,8897
2002-03,U.S. National U18 Team,USDP,42,7,17,24,124,,8897
2002-03,USA U18,WJC-18,6,1,3,4,22,0,8897
2002-03,USA U20,WJC-20,7,2,1,3,2,5,8897
2002-03,Portland Winter Hawks,WHL,53,3,16,19,147,-15,9477
2002-03,Canada U18,WJC-18,7,0,0,0,12,4,9477
2002-03,Canada U18,Nations Cup,5,1,3,4,8,,9477
2002-03,Red Deer Rebels,WHL,71,16,14,30,185,28,8564
2002-03,Canada U18,Nations Cup,5,1,1,2,4,,8564
2002-03,Yunost Minsk,Belarus,4,6,4,10,43,,6666
2002-03,Khimik Voskresensk,Russia2,2,1,1,2,0,2,6666
2002-03,CSKA Moskva,Russia,6,0,0,0,2,-3,6666
2002-03,CSKA Moskva-2,Russia3,3,2,2,4,25,,6666
2002-03,Belarus U18,WJC-18,6,6,9,15,28,-3,6666
2002-03,Belarus U20,WJC-20,6,2,1,3,0,-9,6666
2002-03,Belarus,WC,2,1,0,1,2,-2,6666
2002-03,Belarus (all),International,10,6,0,6,8,,6666
2002-03,Sault Ste. Marie Greyhounds,OHL,61,35,36,71,55,-5,8813
2002-03,Canada U18,WJC-18,7,2,4,6,2,6,8813
2002-03,Dartmouth College,NCAA,34,23,24,47,48,,11748
2002-03,Guelph Storm,OHL,58,34,42,76,89,-9,9099
2002-03,USA U20,WJC-20,7,2,2,4,10,2,9099
2002-03,Lethbridge Hurricanes,WHL,69,9,33,42,113,-14,8879
2002-03,Canada U18,WJC-18,7,3,3,6,4,11,8879
2002-03,Canada U18,Nations Cup,5,1,3,4,29,,8879
2002-03,Leksands IF J18,J18 Allsvenskan,0,0,0,0,0,,352
2002-03,Leksands IF,SHL,41,8,13,21,10,11,352
2002-03,Sweden U20,WJC-20,6,4,2,6,4,2,352
2002-03,Moncton Wildcats,QMJHL,71,49,52,101,90,33,9080
2002-03,Canada U18,WJC-18,7,4,4,8,12,0,9080
2002-03,Canada U18,Nations Cup,5,0,0,0,4,,9080
2002-03,Univ. of North Dakota,NCAA,39,26,35,61,34,,8903
2002-03,USA U20,WJC-20,7,4,4,8,4,2,8903
2002-03,Brandon Wheat Kings,WHL,70,26,29,55,76,17,10352
2002-03,Calgary Hitmen,WHL,70,29,39,68,121,8,8526
2002-03,Canada U18,WJC-18,7,2,2,4,10,6,8526
2002-03,Brampton Battalion,OHL,68,15,25,40,14,5,9103
2002-03,Colorado College,NCAA,38,3,17,20,81,,9401
2002-03,USA U20,WJC-20,7,0,1,1,2,-1,9401
2002-03,Rimouski Océanic,QMJHL,65,32,41,73,100,-24,8919
2002-03,Canada U18,WJC-18,7,2,7,9,6,1,8919
2002-03,Canada U18,Nations Cup,5,0,0,0,2,,8919
2002-03,Ohio State Univ.,NCAA,40,11,20,31,44,4,9014
2002-03,USA U20,WJC-20,7,3,4,7,6,3,9014
2002-03,Kitchener Rangers,OHL,67,37,50,87,99,35,8816
2002-03,Kitchener Rangers,M-Cup,4,2,3,5,8,,8816
2002-03,Canada U18,Nations Cup,5,3,3,6,2,,8816
2002-03,Kingston Frontenacs,OHL,68,32,38,70,47,-25,8893
2002-03,Canada U18,WJC-18,7,6,0,6,6,3,8893
2002-03,Canada U18,Nations Cup,5,2,4,6,2,,8893
2002-03,St. Sebastian's School,USHS-Prep,31,32,31,63,46,,11429
2002-03,Univ. of Michigan,NCAA,43,26,19,45,24,10,9509
2002-03,London Knights,OHL,67,25,53,78,145,5,8541
2002-03,Canada U18,Nations Cup,5,5,5,10,6,,8541
2002-03,Boston College,NCAA,14,10,8,18,61,,9144
2002-03,Tri-City Americans,WHL,66,7,14,21,77,-9,9470
2002-03,Canada U18,WJC-18,7,1,1,2,0,5,9470
2002-03,Canada U18,Nations Cup,5,2,2,4,6,,9470
2002-03,Univ. of Michigan,NCAA,43,3,19,22,48,13,9441
2002-03,Brandon Wheat Kings,WHL,54,14,31,45,158,12,11536
2002-03,Västra Frölunda HC J18,J18 Allsvenskan,0,0,0,0,0,,683
2002-03,Västra Frölunda HC J20,SuperElit,30,16,15,31,10,,683
2002-03,Sweden U18,WJC-18,6,5,2,7,12,-1,683
2002-03,Sweden U18 (all),International-Jr,23,10,6,16,22,,683
2002-03,Calgary Hitmen,WHL,40,2,8,10,210,-2,9464
2002-03,Lokomotiv Yaroslavl,Russia,13,3,4,7,4,0,12239
2002-03,Russia U18,WJC-18,6,2,3,5,20,2,12239
2002-03,HC Karlovy Vary U20,Czech U20,4,2,2,4,18,,9615
2002-03,HC Karlovy Vary,Czech,41,7,9,16,51,7,9615
2002-03,Czech Republic U18,WJC-18,6,3,2,5,18,2,9615
2002-03,Czech Republic U18 (all),International-Jr,6,3,2,5,18,2,9615
2002-03,Czech Republic (all),International,1,0,0,0,0,,9615
2002-03,Toronto St. Michael's Majors,OHL,67,11,33,44,88,8,9507
2002-03,Brampton Battalion,OHL,53,19,42,61,12,17,9612
2002-03,GCK Lions U20,Elite Jr. A,6,2,2,4,2,,9652
2002-03,GC Küsnacht Lions,NLB,12,0,4,4,6,,9652
2002-03,ZSC Lions,NLA,30,3,0,3,12,,9652
2002-03,Switzerland U20,WJC-20,6,2,2,4,2,-4,9652
2002-03,Montréal Rocket,QMJHL,71,35,43,78,28,5,11720
2002-03,Shattuck St. Mary's Midget Prep,USHS-Prep,57,3,20,23,114,,12027
2002-03,Halifax Mooseheads,QMJHL,72,37,46,83,32,47,9633
2002-03,Québec Remparts,QMJHL,72,33,51,84,44,29,10420
2002-03,Québec Remparts,M-Cup,3,0,4,4,4,,10420
2002-03,Kazzinc-Torpedo,Russia2,4,0,0,0,4,-2,9657
2002-03,Torpedo Ust-Kamenogorsk-2,Russia3,-,-,-,-,-,,9657
2002-03,Kazakhstan U18,WJC-18,6,9,1,10,6,-4,9657
2002-03,Kazakhstan U20,WJC-20 D1,5,1,1,2,4,2,9657
2002-03,Acadie-Bathurst Titan,QMJHL,70,23,50,73,62,27,9079
2002-03,Sarnia Sting,OHL,61,32,39,71,79,7,9434
2002-03,River City Lancers,USHL,59,12,30,42,98,26,9108
2002-03,Khimik Voskresensk,Russia2,29,5,4,9,29,9,19732
2002-03,Russia U18,WJC-18,6,4,1,5,4,1,19732
2002-03,Kelowna Rockets,WHL,70,2,16,18,167,25,9505
2002-03,Kelowna Rockets,M-Cup,4,0,0,0,0,,9505
2002-03,HK Dubnica U20,Slovakia U20,16,1,5,6,28,,9654
2002-03,HK Dubnica,Slovakia2,2,0,0,0,0,,9654
2002-03,Slovakia U18,WJC-18,7,1,1,2,8,4,9654
2002-03,New England Jr. Coyotes,EJHL,44,28,40,68,59,,13411
2002-03,Elemash Elektrostal,Russia2,42,14,10,24,24,-9,9579
2002-03,Elemash Elektrostal-2,Russia3,1,0,0,0,0,,9579
2002-03,Barrie Colts,OHL,63,22,24,46,133,16,9149
2002-03,Canada U18,WJC-18,7,1,4,5,4,7,9149
2002-03,Medicine Hat Tigers,WHL,70,36,16,52,90,-11,14086
2002-03,Canada U18,Nations Cup,5,1,3,4,4,,14086
2002-03,Mississauga IceDogs,OHL,56,40,41,81,57,-5,7914
2002-03,USA U20,WJC-20,7,1,2,3,10,0,7914
2002-03,Phillips Andover,USHS-Prep,24,12,12,24,-,,38695
2002-03,Prince Albert Raiders,WHL,58,20,28,48,76,-7,9466
2002-03,Canada U18,WJC-18,7,1,5,6,18,6,9466
2002-03,HC Ceské Budejovice U20,Czech U20,14,1,5,6,34,,9611
2002-03,HC Ceske Budejovice,Czech,31,0,1,1,14,-4,9611
2002-03,Czech Republic (all),International,6,0,0,0,6,,9611
2002-03,Halifax Mooseheads,QMJHL,67,29,29,58,43,5,11506
2002-03,Montréal Rocket,QMJHL,72,22,21,43,55,13,8988
2002-03,Lincoln Stars,USHL,57,28,41,69,126,10,11435
2002-03,Plymouth Whalers,OHL,64,5,11,16,139,15,11022
2002-03,HC Slovan Bratislava U18,Slovakia U18,32,12,15,27,82,,31539
2002-03,HC Slovan Bratislava,Slovakia,8,0,0,0,0,,31539
2002-03,Slovakia U18,WJC-18,7,3,2,5,2,-4,31539
2002-03,Red Deer Rebels,WHL,65,15,20,35,56,15,3209
2002-03,Dynamo Moskva,Russia,50,3,7,10,49,-1,11046
2002-03,Baie-Comeau Drakkar,QMJHL,67,17,12,33,123,12,9026
2002-03,Canada U18,Nations Cup,5,1,0,1,4,,9026
2002-03,Red Deer Rebels,WHL,69,15,37,52,192,24,9504
2002-03,Canada U18,Nations Cup,5,2,1,3,4,,9504
2002-03,Prince George Cougars,WHL,51,27,27,54,45,0,9457
2002-03,CSKA Moskva,Russia,27,0,0,0,2,-6,9581
2002-03,Russia U18,WJC-18,6,0,1,1,6,5,9581
2002-03,IFK Arboga,Allsvenskan,41,9,14,23,30,2,849
2002-03,Sarnia Sting,OHL,68,29,37,66,157,11,9468
2002-03,Canada U18,WJC-18,7,2,2,4,33,4,9468
2002-03,Medicine Hat Tigers,WHL,70,23,52,75,104,-27,8951
2002-03,St. Sebastian's School,USHS-Prep,31,25,29,54,-,,14515
2002-03,Sherbrooke Castors,QMJHL,43,8,16,24,105,0,9645
2002-03,Slovakia U20,WJC-20,6,0,3,3,8,2,9645
2002-03,Prince George Cougars,WHL,36,8,34,42,29,-6,11478
2002-03,Swift Current Broncos,WHL,24,9,17,26,6,4,11478
2002-03,Lincoln Stars,USHL,45,21,34,55,78,15,11773
2002-03,Victoria Salsa,BCHL,32,3,6,9,94,,11722
2002-03,Nanaimo Clippers,BCHL,9,2,4,6,24,,11722
2002-03,Metallurg Magnitogorsk,Russia,32,4,0,4,0,1,9584
2002-03,Russia U18,WJC-18,6,1,3,4,2,2,9584
2002-03,Russia U20,WJC-20,6,0,0,0,6,-1,9584
2002-03,HK Nitra,Slovakia2,17,5,7,12,4,,8682
2002-03,Slovakia U18,WJC-18,7,5,3,8,2,-1,8682
2002-03,UMass (Amherst),NCAA,37,16,22,38,4,20,9405
2002-03,Halifax Mooseheads,QMJHL,71,4,30,34,64,31,8847
2002-03,Canada U18,Nations Cup,5,1,0,1,29,,8847
2002-03,Cornell Univ.,NCAA,32,11,9,20,36,,14035
2002-03,Lincoln Stars,USHL,54,35,43,78,18,32,8850
2002-03,Seattle Thunderbirds,WHL,64,8,14,22,232,11,11879
2002-03,Kamloops Blazers,WHL,67,21,35,56,229,15,38694
2002-03,Northern Michigan Univ.,NCAA,40,4,19,23,64,7,3210
2002-03,HK Dukla Trencin U20,Slovakia U20,23,7,11,18,14,14,9647
2002-03,HK Dukla Trencin,Slovakia,16,0,0,0,0,,9647
2002-03,Hamburg Freezers,DEL,18,0,1,1,18,-4,12396
2002-03,ESV Kaufbeuren,Germany2,26,4,3,7,38,,12396
2002-03,Germany U20,WJC-20,6,0,2,2,14,1,12396
2002-03,Elemash Elektrostal,Russia2,20,1,1,2,8,-6,11352
2002-03,Sudbury Wolves,OHL,62,13,16,29,222,-25,11008
2002-03,Brandon Wheat Kings,WHL,38,9,6,15,87,-2,15335
2002-03,Windsor Spitfires,OHL,65,11,15,26,108,3,15408
2002-03,Lokomotiv Yaroslavl,Russia,11,0,1,1,4,-2,9586
2002-03,Lokomotiv Yaroslavl-2,Russia3,-,-,-,-,-,,9586
2002-03,Russia U18,WJC-18,4,0,0,0,0,2,9586
2002-03,Texas Tornado,NAHL,47,6,23,29,277,,7624
2002-03,Bern U20,Elite Jr. A,5,0,4,4,12,,7964
2002-03,Kloten U20,Elite Jr. A,14,2,10,12,50,,7964
2002-03,Kloten Flyers,NLA,15,0,1,1,4,,7964
2002-03,EHC Bülach,SwissDiv1,8,0,3,3,38,2,7964
2002-03,Switzerland U18,WJC-18,5,0,1,1,68,3,7964
2002-03,HK Gomel,Belarus,17,7,8,15,16,,9658
2002-03,HK Gomel,EEHL,14,2,4,6,10,,9658
2002-03,Yunost Minsk,Belarus,17,18,19,37,34,,9658
2002-03,Belarus U18,WJC-18,6,5,11,16,10,-4,9658
2002-03,Belarus U20,WJC-20,4,1,1,2,4,-4,9658
2002-03,HK Gomel,Belarus Cup,3,2,1,3,2,,9658
2002-03,Peterborough Petes,OHL,65,1,8,9,76,-13,38693
2002-03,Stouffville Spirit,OPJHL,46,43,36,79,51,,14965
2002-03,Hull Olympiques,QMJHL,68,22,34,56,89,4,11564
2002-03,Hull Olympiques,M-Cup,5,0,3,3,12,,11564
2002-03,Brampton Battalion,OHL,65,1,13,14,47,16,11011
2002-03,HC Slavia Praha,Czech,52,6,11,17,44,18,8365
2002-03,Czech Republic,EHT,4,0,2,2,2,,8365
2002-03,Czech Republic,WC,9,0,0,0,4,2,8365
2002-03,Czech Republic (all),International,13,0,2,2,6,,8365
2002-03,Nanaimo Clippers,BCHL,58,27,46,73,59,,14041
2002-03,Genève-Servette HC,NLA,35,2,2,4,18,,9649
2002-03,HC La Chaux-de-Fonds,NLB,1,0,0,0,0,,9649
2002-03,Switzerland U18,WJC-18,6,4,8,12,4,6,9649
2002-03,Switzerland U20,WJC-20,6,2,3,5,0,-3,9649
2002-03,MIF Redhawks J20,SuperElit,11,10,12,22,16,,514
2002-03,MIF Redhawks,SHL,39,2,0,2,10,0,514
2002-03,Sweden U19 (all),International-Jr,6,0,0,0,4,,514
2002-03,Sweden U20,WJC-20,6,2,0,2,0,0,514
2002-03,Halifax Mooseheads,QMJHL,70,2,14,16,54,0,11499
2002-03,Oshawa Generals,OHL,68,36,52,88,57,0,8361
2002-03,Peterborough Petes,OHL,68,31,29,60,32,3,9467
2002-03,Canada U18,WJC-18,7,1,4,5,12,8,9467
2002-03,Canada U18,Nations Cup,5,2,0,2,12,,9467
2002-03,Ottawa 67's,OHL,66,63,88,151,83,46,10314
2002-03,CSK VVS Samara,Russia2,10,1,1,2,10,1,9580
2002-03,Lada Togliatti-2,Russia3,15,2,7,9,4,,9580
2002-03,Russia U18,WJC-18,6,0,4,4,2,5,9580
2002-03,Russia U20,WJC-20,6,0,0,0,6,0,9580
2002-03,Mora IK J18,J18 Allsvenskan,4,3,1,4,8,,669
2002-03,Mora IK J20,SuperElit,20,3,7,10,57,,669
2002-03,Mora IK,Allsvenskan,14,0,0,0,0,0,669
2002-03,Sweden U18,WJC-18,6,1,3,4,45,-2,669
2002-03,Sweden U18 (all),International-Jr,23,3,7,10,57,,669
2002-03,Rouyn-Noranda Huskies,QMJHL,64,15,18,33,233,-11,11497
2002-03,Windsor Spitfires,OHL,51,8,8,16,120,-14,38692
2002-03,Moncton Wildcats,QMJHL,69,1,13,14,241,9,13774
2002-03,HK Dukla Trencin U20,Slovakia U20,17,6,5,11,50,,38691
2002-03,Slovakia U18,WJC-18,7,1,2,3,8,-1,38691
2002-03,Saginaw Spirit,OHL,67,7,16,23,57,-9,9473
2002-03,Canada U18,WJC-18,7,0,1,1,0,5,9473
2002-03,Canada U18,Nations Cup,5,0,0,0,2,,9473
2002-03,Michigan State Univ.,NCAA,35,4,4,8,30,10,9404
2002-03,Rimouski Océanic,QMJHL,65,19,21,40,144,-43,12883
2002-03,Providence College,NCAA,33,2,9,11,18,,17070
2002-03,Dynamo Moskva-2,Russia3,-,-,-,-,-,,12296
2002-03,Rouyn-Noranda Huskies,QMJHL,66,14,29,43,131,4,9472
2002-03,Canada U18,WJC-18,7,1,0,1,8,3,9472
2002-03,St. Albert Saints,AJHL,58,28,54,82,226,,13097
2002-03,HC Poruba U20,Czech U20,31,10,12,22,100,,9673
2002-03,Regina Pats,WHL,70,3,6,9,229,-12,22797
2002-03,Seattle Thunderbirds,WHL,68,17,25,42,47,17,11307
2002-03,London Knights,OHL,66,6,12,18,77,6,10366
2002-03,Lokomotiv Yaroslavl-2,Russia3,-,-,-,-,-,,9894
2002-03,Russia U18,WJC-18,6,3,2,5,2,2,9894
2002-03,Brynäs IF J20,SuperElit,27,11,6,17,93,,618
2002-03,Brynäs IF,SHL,3,0,0,0,0,0,618
2002-03,Sweden U18,WJC-18,6,1,3,4,16,1,618
2002-03,Sweden U18 (all),International-Jr,23,3,3,6,59,,618
2002-03,Sioux Falls Stampede,USHL,60,13,34,47,88,-5,11445
2002-03,Vernon Vipers,BCHL,56,6,22,28,99,,15420
2002-03,Jokerit U18,Jr. B SM-sarja,10,12,6,18,2,,3208
2002-03,Jokerit U20,Jr. A SM-liiga,31,8,9,17,8,6,3208
2002-03,Finland U18,WJC-18,6,4,1,5,4,3,3208
2002-03,Deerfield Academy,USHS-Prep,25,14,25,39,-,,24299
2002-03,River City Lancers,USHL,59,3,12,15,62,7,15294
2002-03,Univ. of Maine,NCAA,33,9,7,16,10,5,9403
2002-03,USA U20,WJC-20,7,0,0,0,0,-3,9403
2002-03,Colorado College,NCAA,36,27,11,38,30,,9408
2002-03,USA U20,WJC-20,7,0,2,2,4,0,9408
2002-03,New England Jr. Coyotes,EJHL,50,38,29,67,110,,13616
2002-03,Västra Frölunda HC J18,J18 Allsvenskan,0,0,0,0,0,,685
2002-03,Västra Frölunda HC J20,SuperElit,30,22,13,35,18,,685
2002-03,Sweden U18,WJC-18,6,0,1,1,6,-1,685
2002-03,Sweden U18 (all),International-Jr,23,1,3,4,12,,685
2002-03,Dartmouth College,NCAA,34,21,28,49,32,,10199
2002-03,Kootenay Ice,WHL,72,47,45,92,54,2,9503
2002-03,Canada U18,Nations Cup,5,5,6,11,2,,9503
2002-03,Tri-City Storm,USHL,23,1,3,4,64,-9,15960
2002-03,Des Moines Buccaneers,USHL,34,1,6,7,40,-4,15960
2002-03,Kärpät,Liiga,56,6,12,18,67,41,2717
2002-03,Finland,EHT,8,0,0,0,4,1,2717
2002-03,Finland (all),International,8,0,0,0,4,1,2717
2002-03,Salmon Arm Silverbacks,BCHL,59,42,59,101,30,,9440
2002-03,Compuware Ambassadors,NAHL,53,30,14,44,36,,11411
2002-03,Proctor Academy,USHS-Prep,34,37,-,-,-,,59185
2002-03,Lokomotiv Yaroslavl-2,Russia3,-,-,-,-,-,,38690
2002-03,Russia U18,WJC-18,6,1,2,3,6,1,38690
2002-03,Podhale Nowy Targ,Poland,30,2,4,6,10,,13650
2002-03,Poland U18,WJC-18 D1,5,4,3,7,0,2,13650
2002-03,Poland U20,WJC-20 D1,5,2,1,3,6,-2,13650
2002-03,Plymouth Whalers,OHL,68,18,37,55,31,18,11487
2002-03,Brynäs IF J20,SuperElit,21,21,12,33,24,,610
2002-03,Brynäs IF,SHL,26,0,4,4,10,-2,610
2002-03,Sweden U19 (all),International-Jr,7,0,0,0,6,,610
2002-03,Severstal Cherepovets,Russia,36,0,3,3,12,-3,38687
2002-03,HC Litvinov U20,Czech U20,22,0,3,3,36,,11403
2002-03,Czech Republic U18,WJC-18,6,0,0,0,29,-3,11403
2002-03,Czech Republic U18 (all),International-Jr,6,0,0,0,29,-3,11403
2002-03,Owen Sound Attack,OHL,67,27,40,67,54,-10,10211
2002-03,Brampton Battalion,OHL,61,21,22,43,6,21,11764
2002-03,Univ. of Minnesota,NCAA,41,13,16,29,10,,9445
2002-03,USA U20,WJC-20,7,1,2,3,4,0,9445
2002-03,Severstal Cherepovets,Russia,11,0,0,0,4,0,19551
2002-03,Chilliwack Chiefs,BCHL,53,5,28,33,86,,14337
2002-03,London Knights,OHL,68,2,13,15,46,1,10993
2002-03,HC Sparta Praha U20,Czech U20,34,3,8,11,22,,22363
2002-03,Czech Republic U18,WJC-18,6,1,2,3,30,-3,22363
2002-03,Linköping HC J20,J20 Elit,-,-,-,-,-,,2031
2002-03,Linköping HC,SHL,8,0,1,1,0,2,2031
2002-03,Metallurg Novokuznetsk,Russia,11,1,0,1,0,1,19107
2002-03,Mississauga IceDogs,OHL,68,9,27,36,81,-9,13647
2002-03,Moose Jaw Warriors,WHL,49,8,6,14,39,4,58131
2002-03,Tappara,Liiga,56,23,14,37,6,6,2713
2002-03,Finland,EHT,7,1,2,3,4,,2713
2002-03,Finland,WC,6,2,3,5,4,1,2713
2002-03,Merritt Centennials,BCHL,56,42,51,93,133,,13796
2002-03,HC Slovan Bratislava U18,Slovakia U18,0,0,0,0,0,0,18451
2002-03,HC Slovan Bratislava U20,Slovakia U20,33,13,13,26,45,13,18451
2002-03,HC Slovan Bratislava,Slovakia,8,1,0,1,0,1,18451
2002-03,Slovakia U18,WJC-18,7,1,1,2,6,-5,18451
2002-03,Seattle Thunderbirds,WHL,67,6,9,15,91,7,15682
2002-03,Bern U20,Elite Jr. A,11,1,11,12,12,,12664
2002-03,SC Bern,NLA,27,0,1,1,6,,12664
2002-03,Switzerland U18,WJC-18,6,1,3,4,20,3,12664
2002-03,Switzerland U20,WJC-20,6,0,0,0,4,-2,12664
2002-03,IF Troja-Ljungby,Allsvenskan,20,8,4,12,16,4,838
2002-03,Acadie-Bathurst Titan,QMJHL,72,22,28,50,73,47,10226
2002-03,Seattle Thunderbirds,WHL,61,10,24,34,48,7,10261
2002-03,Södertälje SK J20,SuperElit,24,19,14,33,28,,549
2002-03,Södertälje SK,SHL,22,2,3,5,4,-6,549
2002-03,Sweden U19 (all),International-Jr,7,0,1,1,6,,549
2002-03,Hull Olympiques,QMJHL,72,9,18,27,143,5,13999
2002-03,Hull Olympiques,M-Cup,5,1,1,2,4,,13999
2002-03,Capital Centre Pride,NAHL,11,10,9,19,-,,11405
2002-03,River City Lancers,USHL,49,14,11,25,26,17,11405
2002-03,Peterborough Petes,OHL,68,5,24,29,18,10,10403
2002-03,St. Cloud State Univ.,NCAA,35,8,8,16,18,-1,15345
2002-03,Vernon Vipers,BCHL,58,8,16,24,63,,14650
2002-03,Hull Olympiques,QMJHL,71,10,34,44,102,35,8940
2002-03,Hull Olympiques,M-Cup,5,1,2,3,4,,8940
2002-03,Hammarby IF J18,J18 Allsvenskan,3,0,0,0,4,,2271
2002-03,Hammarby IF J20,SuperElit,24,4,2,6,8,,2271
2002-03,Battlefords North Stars,SJHL,55,17,46,63,248,,12923
2002-03,Leksands IF J18,J18 Allsvenskan,0,0,0,0,0,,658
2002-03,Leksands IF J20,SuperElit,29,0,4,4,49,,658
2002-03,Borlänge HF,Division 1,2,0,0,0,0,,658
2002-03,Sweden U18 (all),International-Jr,17,2,3,5,4,,658
2002-03,Sweden U18,WJC-18,6,1,0,1,0,-3,658
2002-03,Red Deer Rebels,WHL,67,17,15,32,84,16,4344
2002-03,Lokomotiv Yaroslavl,Russia,48,10,17,27,32,30,21043
2002-03,Russia,EHT,7,0,0,0,2,,21043
2002-03,Russia,WC,6,0,0,0,4,0,21043
2002-03,Acadie-Bathurst Titan,QMJHL,62,0,1,1,232,-10,11811
2002-03,Moose Jaw Warriors,WHL,59,15,39,54,81,5,8902
2002-03,Canada U20,WJC-20,6,1,0,1,4,4,8902
2002-03,Russia U18,WJC-18,6,1,0,1,4,1,19734
2002-03,Brynäs IF J20,SuperElit,19,4,7,11,4,,604
2002-03,Södertälje SK J20,SuperElit,9,4,2,6,0,,604
2002-03,Sweden U18,WJC-18,6,2,0,2,12,-1,604
2002-03,Sweden U18 (all),International-Jr,23,10,4,14,12,,604
2002-03,Waterloo Black Hawks,USHL,60,36,33,69,32,26,10372
2002-03,Drummondville Voltigeurs,QMJHL,67,5,3,8,474,-12,11889
2002-03,Dynamo Energia Yekaterinburg,Russia2,28,1,3,4,18,4,9585
2002-03,Russia U18,WJC-18,6,0,2,2,2,8,9585
2002-03,Kelowna Rockets,WHL,67,25,20,45,93,31,11473
2002-03,Kelowna Rockets,M-Cup,4,0,0,0,6,,11473
2002-03,Pittsburgh Forge,NAHL,56,11,30,41,98,,13412
2002-03,CSKA Moskva,Russia,50,3,7,10,30,4,19387
2002-03,Moose Jaw Warriors,WHL,72,32,30,62,84,4,9097
2002-03,Val-d'Or Foreurs,QMJHL,52,11,21,32,164,17,8923
2002-03,Kölner Haie,DEL,21,0,2,2,0,1,15405
2002-03,Kölner EC U18,DNL,29,39,42,81,20,,15405
2002-03,Germany U18,WJC-18 D1,5,7,3,10,4,4,15405
2002-03,Germany U20,WJC-20,6,0,1,1,0,-6,15405
2002-03,Kärpät U20,Jr. A SM-liiga,23,3,7,10,8,13,3205
2002-03,Kärpät,Liiga,23,0,1,1,4,-3,3205
2002-03,Northern Michigan Univ.,NCAA,41,11,22,33,55,,14649
2002-03,Vancouver Giants,WHL,71,43,42,85,24,-7,12833
2002-03,Swift Current Broncos,WHL,72,41,52,93,117,18,11175
2002-03,Kapitan Stupino,EEHL,31,4,4,8,2,,19596
2002-03,Halifax Mooseheads,QMJHL,72,38,49,87,24,53,13417
2002-03,Sherbrooke Castors,QMJHL,33,8,8,16,18,1,9475
2002-03,Rimouski Océanic,QMJHL,38,12,26,38,69,-24,9475
2002-03,Canada U18,WJC-18,7,0,1,1,16,2,9475
2002-03,Coquitlam Express,BCHL,60,42,50,92,50,,13617
2002-03,Hammarby IF,Allsvenskan,41,13,9,22,55,28,641
2002-03,Olds Grizzlys,AJHL,59,1,4,5,219,,8926
2002-03,Ottawa 67's,OHL,56,1,6,7,23,10,18009
2002-03,Cape Breton Screaming Eagles,QMJHL,72,28,42,70,54,-36,9465
2002-03,Canada U18,WJC-18,7,3,3,6,4,3,9465
2002-03,Canada U18,Nations Cup,5,2,4,6,12,,9465
2002-03,Des Moines Buccaneers,USHL,60,14,25,39,120,-12,50045
2002-03,St. Cloud State Univ.,NCAA,37,9,9,18,14,2,11719
2002-03,Shawinigan Cataractes,QMJHL,72,24,26,50,60,-6,11325
2002-03,HC Slavia Praha,Czech,49,4,19,23,46,23,10862
2002-03,Czech Republic,EHT,14,2,0,2,8,,10862
2002-03,Czech Republic,WC,9,1,6,7,12,-3,10862
2002-03,Czech Republic (all),International,25,3,6,9,20,,10862
2002-03,HV71 J20,SuperElit,24,11,14,25,24,,648
2002-03,HV71,SHL,1,0,0,0,2,0,648
2002-03,Tranås AIF,Allsvenskan,5,1,0,1,0,,648
2002-03,Sweden U19 (all),International-Jr,3,0,0,0,0,,648
2002-03,Moose Jaw Warriors,WHL,45,8,16,24,53,1,22703
2002-03,Calgary Hitmen,WHL,30,7,9,16,18,2,22703
2002-03,Univ. of Nebraska-Omaha,NCAA,38,0,5,5,103,,11716
2002-03,MODO Hockey J20,SuperElit,7,4,6,10,31,3,594
2002-03,MODO Hockey,SHL,42,1,5,6,16,-2,594
2002-03,Sweden U19 (all),International-Jr,2,0,0,0,6,,594
2002-03,Sweden U20,WJC-20,6,1,1,2,4,1,594
2002-03,Sweden (all),International,2,0,0,0,0,,594
2002-03,Kamloops Blazers,WHL,71,7,13,20,54,13,11741
2002-03,Montréal Rocket,QMJHL,65,1,5,6,261,-1,12488
2002-03,Kölner Haie,DEL,46,6,14,20,46,9,18838
2002-03,Germany,WC,7,0,3,3,2,-2,18838
2002-03,Kölner Haie,Spengler Cup,3,1,0,1,2,,18838
2002-03,HC Trinec,Czech,51,32,30,62,42,28,8736
2002-03,Czech Republic,EHT,4,1,0,1,2,,8736
2002-03,Czech Republic (all),International,10,2,2,4,4,,8736
2002-03,Brandon Wheat Kings,WHL,8,1,1,2,4,1,10667
2002-03,Prince George Cougars,WHL,48,9,28,37,74,10,10667
2002-03,Salavat Yulaev Ufa,Russia,41,9,5,14,32,5,15026
2002-03,Baie-Comeau Drakkar,QMJHL,25,2,16,21,12,3,13425
2002-03,Shawinigan Cataractes,QMJHL,35,6,35,41,21,6,13425
2002-03,Canada U18,Nations Cup,5,0,2,2,4,,13425
2002-03,HC Vsetin U20,Czech U20,30,6,7,13,12,,12294
2002-03,HC Vsetin,Czech,6,0,0,0,4,-4,12294
2002-03,Notre Dame Hounds,SJHL,53,27,51,78,16,,14078
2002-03,Kingston Frontenacs,OHL,28,8,15,23,90,-1,10228
2002-03,Toronto St. Michael's Majors,OHL,34,8,11,19,108,-20,10228
2002-03,Chicoutimi Saguenéens,QMJHL,69,20,27,47,62,-16,14046
2002-03,Avangard Omsk-2,Russia3,45,16,5,21,18,,12242
2002-03,Lokomotiv Yaroslavl,Russia,9,0,1,1,0,-4,12231
2002-03,Lokomotiv Yaroslavl-2,Russia3,-,-,-,-,-,,12231
2002-03,Russia U18,WJC-18,6,0,3,3,12,6,12231
2002-03,Toronto St. Michael's Majors,OHL,68,5,10,15,121,5,10353
2002-03,Stalkers Juniors Daugavpils,Latvia,-,4,5,9,18,,30660
2002-03,Stalkers Juniors Daugavpils,EEHL B,18,7,15,22,29,,30660
2002-03,Latvia U18,WJC-18 D1,5,2,0,2,4,-1,30660
2002-03,Latvia U20,WJC-20 D1,5,0,2,2,12,-2,30660
2002-03,Chicago Steel,USHL,57,9,20,29,225,-18,12040
2002-03,Regina Pats,WHL,37,2,3,5,63,1,52326
2002-03,Québec Remparts,QMJHL,66,7,12,19,37,1,38684
2002-03,Québec Remparts,M-Cup,3,0,0,0,0,,38684
2002-03,Jokerit U18,Jr. B SM-sarja,7,2,6,8,8,,3204
2002-03,Jokerit U20,Jr. A SM-liiga,33,1,1,2,8,11,3204
2002-03,Finland U18,WJC-18,6,0,0,0,6,3,3204
2002-03,KooKoo,Mestis,44,20,15,35,20,22,3203
2002-03,Finland II (all),International,3,0,0,0,0,-3,3203
2002-03,Finland II,Nagano Cup,3,0,0,0,0,-2,3203
2002-03,Sarnia Sting,OHL,68,41,71,112,75,37,11557
2002-03,Toronto St. Michael's Majors,OHL,55,11,19,30,20,-10,38682
2002-03,Cornell Univ.,NCAA,33,13,10,23,22,,9744
2002-03,Sarnia Sting,OHL,60,30,32,62,112,25,18037
2002-03,Penticton Panthers,BCHL,32,15,25,40,108,,14085
2002-03,Nanaimo Clippers,BCHL,18,8,14,22,46,,14085
2002-03,Baie-Comeau Drakkar,QMJHL,65,23,53,76,63,25,15723
2002-03,Boston College High,USHS-Prep,-,23,22,45,-,,11885
2002-03,Lukko U18,Jr. B SM-sarja,13,10,10,20,6,,3202
2002-03,Lukko U20,Jr. A SM-liiga,13,6,4,10,6,5,3202
2002-03,Latvia U18,WJC-18 D1,5,1,1,2,2,-1,3202
2002-03,Latvia U20,WJC-20 D1,5,2,2,4,0,3,3202
2002-03,Notre Dame Hounds,SJHL,57,20,36,56,164,,14047
2002-03,Oakville Blades,OPJHL,19,7,15,22,127,,17021
2002-03,Georgetown Raiders,OPJHL,16,4,9,13,34,,17021
2002-03,St. Sebastian's School,USHS-Prep,31,9,30,39,59,,12051
2002-03,Ak Bars Kazan,Russia,47,7,6,13,47,11,18036
2002-03,Des Moines Buccaneers,USHL,60,27,33,60,30,14,14453
2002-03,Chicago Steel,USHL,51,3,13,16,48,15,15295
2002-03,Kelowna Rockets,WHL,35,4,4,8,36,2,11723
2002-03,Kelowna Rockets,M-Cup,4,0,0,0,2,,11723
2002-03,Kelowna Rockets,WHL,50,4,8,12,109,-1,18035
2002-03,Kelowna Rockets,M-Cup,4,0,0,0,2,,18035
2002-03,Tappara U20,Jr. A SM-liiga,33,3,12,15,26,-3,3201
2002-03,Tappara,Liiga,8,0,0,0,0,-1,3201
2002-03,Finland U18,WJC-18,6,1,3,4,6,3,3201
2002-03,Québec Remparts,QMJHL,68,5,14,19,164,17,27320
2002-03,Québec Remparts,M-Cup,3,0,0,0,0,,27320
2002-03,Lincoln Stars,USHL,59,13,22,35,74,5,14133
2002-03,Peterborough Petes,OHL,56,1,8,9,128,-9,15540
2002-03,Kärpät U18,Jr. B SM-sarja,2,5,1,6,6,,3200
2002-03,Kärpät U20,Jr. A SM-liiga,33,19,3,22,30,18,3200
2002-03,Kärpät,Liiga,1,0,0,0,-2,,3200
2002-03,Finland U18,WJC-18,6,0,1,1,4,-1,3200
2002-03,Seattle Thunderbirds,WHL,51,3,18,21,24,21,59183
2002-03,Rimouski Océanic,QMJHL,65,10,14,24,131,-60,9618
2002-03,Czech Republic U18,WJC-18,6,1,0,1,29,-6,9618
2002-03,Czech Republic U18 (all),International-Jr,6,1,0,1,29,-6,9618
2002-03,Kelowna Rockets,WHL,39,4,12,16,39,-5,8846
2002-03,Lethbridge Hurricanes,WHL,30,5,8,13,45,-4,8846
2002-03,Coquitlam Express,BCHL,35,9,19,28,55,,11426
2002-03,Arvika HC,Division 1,30,13,28,41,89,,2647
2002-03,HC Ambrì-Piotta,NLA,44,12,22,34,42,,10823
2003-04,Dynamo Moskva,Russia,53,13,11,24,40,7,4230
2003-04,Russia U20,WJC-20,6,5,2,7,25,2,4230
2003-04,Russia,WCup,2,1,0,1,0,,4230
2003-04,Russia,EHT,8,4,2,6,0,,4230
2003-04,Russia,WC,6,1,1,2,0,0,4230
2003-04,Metallurg Magnitogorsk,Russia,34,3,9,12,12,11,4231
2003-04,Metallurg Magnitogorsk-2,Russia3,2,1,0,1,8,,4231
2003-04,Russia U18,WJC-18,6,4,4,8,31,4,4231
2003-04,Russia U20,WJC-20,6,1,4,5,0,2,4231
2003-04,Medicine Hat Tigers,WHL,69,21,44,65,105,-17,9198
2003-04,Medicine Hat Tigers,M-Cup,4,0,2,2,10,3,9198
2003-04,Canada U18,Hlinka Memorial,5,2,0,2,4,,9198
2003-04,Calgary Hitmen,WHL,71,30,45,75,119,39,6668
2003-04,Team Northwest,UMEHL,24,5,6,11,-,,9215
2003-04,Breck School,USHS-MN,27,39,50,89,34,,9215
2003-04,HC Vitkovice U20,Czech U20,3,2,0,2,0,2,8652
2003-04,HC Vitkovice,Czech,35,1,11,12,10,6,8652
2003-04,Czech Republic U20,WJC-20,6,3,2,5,6,4,8652
2003-04,Czech Republic U20 (all),International-Jr,17,6,8,14,12,,8652
2003-04,Czech Republic (all),International,2,0,0,0,0,,8652
2003-04,Lewiston MAINEiacs,QMJHL,69,39,31,80,88,4,6670
2003-04,QMJHL All-Stars,CHL Challenge,2,1,5,6,0,,6670
2003-04,HC Liberec U20,Czech U20,14,4,10,14,38,0,9225
2003-04,Bili Tygri Liberec,Czech,45,1,1,2,51,-5,9225
2003-04,HC Berounsti Medvedi,Czech2,0,0,0,0,0,,9225
2003-04,Czech Republic U18,WJC-18,5,0,2,2,0,1,9225
2003-04,Czech Republic U18 (all),International-Jr,11,2,3,5,0,,9225
2003-04,Czech Republic U20,WJC-20,6,1,2,3,4,2,9225
2003-04,Czech Republic U20 (all),International-Jr,16,3,5,8,10,2,9225
2003-04,Kitchener Rangers,OHL,68,3,12,15,278,2,9244
2003-04,Slovakia U18,WJC-18,6,0,3,3,26,5,9244
2003-04,Blues U20,Jr. A SM-liiga,14,14,9,23,4,6,3199
2003-04,Blues,Liiga,35,3,3,6,16,-2,3199
2003-04,Suomi U20,Mestis,6,0,0,0,6,-3,3199
2003-04,Finland U18,WJC-18,6,5,6,11,10,7,3199
2003-04,Finland U20,WJC-20,7,2,1,3,2,0,3199
2003-04,Michigan State Univ.,NCAA,41,11,18,29,50,16,11595
2003-04,Univ. of North Dakota,NCAA,36,11,21,32,30,,9180
2003-04,USA U20,WJC-20,6,0,2,2,2,4,9180
2003-04,THK Tver,Russia2,42,15,16,31,102,6,8794
2003-04,Dynamo Moskva,Russia,1,0,0,0,2,-2,8794
2003-04,Dynamo Moskva-2,Russia3,-,-,-,-,-,,8794
2003-04,Russia U18,WJC-18,6,2,5,7,2,7,8794
2003-04,SaiPa U20,Jr. A SM-liiga,10,5,3,8,4,6,4128
2003-04,SaiPa,Liiga,40,4,4,8,16,-4,4128
2003-04,Suomi U20,Mestis,3,0,1,1,0,1,4128
2003-04,Finland U18,WJC-18,6,5,6,11,16,5,4128
2003-04,Finland U20,WJC-20,7,1,0,1,0,2,4128
2003-04,Prince Albert Raiders,WHL,64,15,33,48,118,6,9192
2003-04,Canada U18,WJC-18,7,3,2,5,28,0,9192
2003-04,Canada U18,Hlinka Memorial,5,1,0,1,2,,9192
2003-04,TPS U18,Jr. B SM-sarja,0,0,0,0,0,,4219
2003-04,TPS U20,Jr. A SM-liiga,36,12,8,20,20,12,4219
2003-04,Finland U18,WJC-18,6,5,6,11,2,7,4219
2003-04,Salmon Arm Silverbacks,BCHL,59,43,69,112,110,,10232
2003-04,Brampton Battalion,OHL,66,29,41,70,30,4,8832
2003-04,OHL All-Stars,CHL Challenge,2,1,1,2,0,,8832
2003-04,Canada U18,JWC-18,5,1,4,5,4,,8832
2003-04,HC Litvinov U20,Czech U20,23,21,14,35,56,5,9616
2003-04,HC Litvinov,Czech,37,4,2,6,10,0,9616
2003-04,HC Slovan Ústečtí Lvi,Czech2,1,1,0,1,0,1,9616
2003-04,HC Most,Czech3,0,0,0,0,0,,9616
2003-04,Czech Republic U20,WJC-20,6,0,3,3,2,2,9616
2003-04,Czech Republic U20 (all),International-Jr,16,3,8,11,4,,9616
2003-04,HK Dukla Trencin U20,Slovakia U20,5,2,2,4,0,7,8664
2003-04,HK Dukla Trencin,Slovakia,44,3,3,6,8,,8664
2003-04,Slovakia U20,WJC-20,6,1,1,2,12,1,8664
2003-04,Slovakia,WC,7,0,1,1,2,0,8664
2003-04,Slovakia (all),International,7,0,1,1,2,0,8664
2003-04,Salmon Arm Silverbacks,BCHL,53,32,55,87,161,,11434
2003-04,Mississauga IceDogs,OHL,3,2,4,6,0,1,8876
2003-04,London Knights,OHL,60,28,41,69,18,14,8876
2003-04,U.S. National U18 Team,USDP,2,0,0,0,8,,8876
2003-04,Calgary Hitmen,WHL,72,11,24,35,33,28,9490
2003-04,Canada U18,WJC-18,7,0,0,0,2,5,9490
2003-04,Vancouver Giants,WHL,72,1,11,12,192,-8,8399
2003-04,Saskatoon Blades,WHL,59,14,25,39,92,-26,9476
2003-04,WHL All-Stars,CHL Challenge,2,0,0,0,0,,9476
2003-04,Calgary Hitmen,WHL,64,1,3,4,89,11,9483
2003-04,Canada U18,WJC-18,7,1,2,3,26,-1,9483
2003-04,Djurgårdens IF J20,SuperElit,6,4,9,13,6,,1269
2003-04,Djurgårdens IF,SHL,25,0,3,3,4,4,1269
2003-04,Almtuna IS,Allsvenskan,2,0,0,0,0,-1,1269
2003-04,Sweden U18 (all),International-Jr,5,0,1,1,2,,1269
2003-04,Sweden U20,WJC-20,6,0,1,1,4,3,1269
2003-04,London Knights,OHL,65,37,30,67,58,17,9193
2003-04,Cushing Academy,USHS-Prep,31,37,53,90,96,,6667
2003-04,Luleå HF J20,SuperElit,5,0,2,2,10,,507
2003-04,Luleå HF,SHL,44,3,3,6,28,9,507
2003-04,Sweden U20,WJC-20,6,3,0,3,2,-2,507
2003-04,Sweden U20 (all),International-Jr,12,3,3,6,10,,507
2003-04,Sweden (all),International,1,0,0,0,4,,507
2003-04,Tri-City Americans,WHL,69,3,8,11,112,2,11474
2003-04,Northern Michigan Univ.,NCAA,41,13,21,34,26,-3,11418
2003-04,Sault Ste. Marie Greyhounds,OHL,68,6,20,26,140,12,18015
2003-04,Dartmouth College,NCAA,34,3,22,25,57,,14106
2003-04,Ottawa 67's,OHL,59,20,16,36,76,-9,11346
2003-04,Krylia Sovetov,Russia2,46,7,8,15,40,-1,9259
2003-04,Krylia Sovetov Moskva-2,Russia3,4,3,1,4,2,,9259
2003-04,Russia U18,WJC-18,6,5,6,11,18,6,9259
2003-04,Portland Winter Hawks,WHL,71,3,25,28,86,-9,9482
2003-04,Canada U18,WJC-18,7,0,1,1,2,3,9482
2003-04,Kamloops Blazers,WHL,70,5,9,14,118,-6,11605
2003-04,Guelph Storm,OHL,36,16,18,34,32,11,9488
2003-04,Windsor Spitfires,OHL,16,3,10,13,12,4,9488
2003-04,Canada U18,WJC-18,7,1,4,5,6,-1,9488
2003-04,Boston College,NCAA,29,4,4,8,30,,9415
2003-04,Kelowna Rockets,WHL,71,10,23,33,123,13,9190
2003-04,Kelowna Rockets,M-Cup,4,0,0,0,6,0,9190
2003-04,Canada U18,Hlinka Memorial,5,0,0,0,6,,9190
2003-04,Prince Albert Raiders,WHL,51,9,8,17,134,-5,9489
2003-04,Canada U18,WJC-18,7,0,1,1,8,1,9489
2003-04,Malmö Redhawks J20,SuperElit,27,23,25,48,30,,665
2003-04,Malmö Redhawks,SHL,24,1,1,2,8,-8,665
2003-04,Sweden U19 (all),International-Jr,3,1,1,2,2,,665
2003-04,Dynamo Moskva-2,Russia3,-,-,-,-,-,,9255
2003-04,Kristall Saratov,Russia2,35,10,6,16,30,2,9255
2003-04,Russia U18,WJC-18,6,1,0,1,12,-1,9255
2003-04,Moncton Wildcats,QMJHL,68,24,33,57,89,-4,14004
2003-04,Nanaimo Clippers,BCHL,54,20,32,52,93,,11425
2003-04,Nanaimo Clippers,RBC Cup,4,1,3,4,8,,11425
2003-04,Michigan State Univ.,NCAA,30,8,10,18,30,6,9402
2003-04,USA U20,WJC-20,6,0,1,1,2,3,9402
2003-04,HC Sparta Praha U20,Czech U20,13,8,14,22,4,1,9229
2003-04,HC Sparta Praha,Czech,34,5,1,6,14,3,9229
2003-04,HC Dukla Jihlava,Czech2,1,0,0,0,0,-1,9229
2003-04,Czech Republic U18,WJC-18,7,3,3,6,6,6,9229
2003-04,Czech Republic U18 (all),International-Jr,11,5,4,9,8,,9229
2003-04,Czech Republic U20,WJC-20,5,0,1,1,0,0,9229
2003-04,Czech Republic U20 (all),International-Jr,17,3,3,6,6,0,9229
2003-04,Green Bay Gamblers,USHL,58,11,26,37,33,3,41101
2003-04,Södertälje SK J20,SuperElit,33,1,2,3,32,,2439
2003-04,Södertälje SK,SHL,1,0,0,0,0,0,2439
2003-04,Sweden U19 (all),International-Jr,4,0,0,0,6,,2439
2003-04,U.S. National U18 Team,NAHL,11,4,2,6,31,,9213
2003-04,USA U18,WJC-18,6,0,0,0,8,-2,9213
2003-04,CSKA Moskva,Russia,28,0,3,3,12,-1,9254
2003-04,CSKA Moskva-2,Russia3,13,1,2,3,26,,9254
2003-04,Russia U18,WJC-18,6,1,0,1,20,2,9254
2003-04,Ottawa 67's,OHL,43,4,10,14,50,9,9484
2003-04,Canada U18,WJC-18,7,0,0,0,8,1,9484
2003-04,Portland Winter Hawks,WHL,71,30,48,78,137,-4,11024
2003-04,Grand Rapids High,USHS-MN,26,25,31,56,16,,9435
2003-04,Sioux Falls Stampede,USHL,10,0,2,2,6,-5,9435
2003-04,Krylia Sovetov,Russia2,38,5,10,15,12,4,9260
2003-04,Krylia Sovetov Moskva-2,Russia3,10,4,1,5,6,,9260
2003-04,Russia U18,WJC-18,6,0,4,4,8,5,9260
2003-04,HC Kladno U20,Czech U20,50,23,37,60,37,4,9226
2003-04,Czech Republic U18,WJC-18,7,3,4,7,0,7,9226
2003-04,Czech Republic U18 (all),International-Jr,10,4,4,8,0,,9226
2003-04,Czech Republic U19 (all),International-Jr,3,0,0,0,2,,9226
2003-04,Moncton Wildcats,QMJHL,60,30,23,53,76,6,9238
2003-04,Latvia U20,WJC-20 D1,5,7,6,13,22,7,9238
2003-04,Rimouski Océanic,QMJHL,69,22,16,38,112,6,11524
2003-04,Jokerit,Liiga,53,3,4,7,20,4,4127
2003-04,Suomi U20,Mestis,1,0,0,0,0,-2,4127
2003-04,Finland U20,WJC-20,7,4,4,8,10,10,4127
2003-04,St. Albert Saints,AJHL,51,35,36,71,33,,17765
2003-04,Oshawa Generals,OHL,66,17,29,46,44,-2,9493
2003-04,Canada U18,WJC-18,7,1,2,3,26,-2,9493
2003-04,St. Cloud State Univ.,NCAA,32,0,9,9,18,-2,9419
2003-04,London Knights,OHL,64,19,33,52,269,23,8920
2003-04,HK Dukla Trencin U18,Slovakia U18,3,0,0,0,2,,9249
2003-04,HK Dukla Trencin U20,Slovakia U20,45,5,12,17,16,,9249
2003-04,HK Dukla Trencin II,Slovakia2,5,0,0,0,0,,9249
2003-04,HK Dukla Trencin,Slovakia,3,0,0,0,2,,9249
2003-04,Slovakia U18,WJC-18,6,1,1,2,18,0,9249
2003-04,CSKA Moskva,Russia,27,2,4,6,4,2,9588
2003-04,CSKA Moskva-2,Russia3,28,12,16,28,28,,9588
2003-04,Russia U18,WJC-18,6,0,3,3,0,2,9588
2003-04,HC Litvinov U20,Czech U20,52,14,15,29,204,2,9235
2003-04,Czech Republic U18,WJC-18,7,1,3,4,6,6,9235
2003-04,Czech Republic U18 (all),International-Jr,13,2,6,8,14,6,9235
2003-04,Czech Republic U19 (all),International-Jr,3,2,0,2,0,0,9235
2003-04,Green Bay Gamblers,USHL,57,6,21,27,124,10,9411
2003-04,Toronto St. Michael's Majors,OHL,53,26,41,67,105,16,9508
2003-04,Canada U20,WJC-20,6,1,2,3,4,1,9508
2003-04,OHL All-Stars,CHL Challenge,2,1,1,2,2,,9508
2003-04,Toronto St. Michael's Majors,OHL,66,5,27,32,189,12,11756
2003-04,Capital District Selects,EJHL,36,17,22,39,117,,9436
2003-04,HK Dukla Trencin U20,Slovakia U20,40,16,20,36,74,46,11772
2003-04,HK Dukla Trencin II,Slovakia2,2,0,0,0,0,0,11772
2003-04,HK Dukla Trencin,Slovakia,16,0,0,0,18,-2,11772
2003-04,Tri-City Americans,WHL,71,7,24,31,109,21,11361
2003-04,Cushing Academy,USHS-Prep,37,35,55,90,40,,14877
2003-04,Plymouth Whalers,OHL,67,14,28,42,108,1,12114
2003-04,THK Tver,Russia2,21,8,3,11,14,2,11495
2003-04,Russia U18,WJC-18,6,3,0,3,4,3,11495
2003-04,Metallurg Novokuznetsk,Russia,57,5,4,9,24,-6,12297
2003-04,Lada Togliatti-2,Russia3,2,0,0,0,10,,9253
2003-04,CSK VVS Samara,Russia2,53,2,4,6,198,-9,9253
2003-04,Russia U18,WJC-18,6,0,0,0,10,0,9253
2003-04,Moorhead High,USHS-MN,26,19,37,56,26,,15041
2003-04,Lethbridge Hurricanes,WHL,62,21,24,45,31,8,9487
2003-04,Canada U18,WJC-18,7,3,0,3,0,-2,9487
2003-04,Herning Blue Fox,Denmark,33,9,11,20,14,,4104
2003-04,Denmark U18,WJC-18,6,5,4,9,0,6,4104
2003-04,Denmark U20,WJC-20 D1,5,1,2,3,2,3,4104
2003-04,Seattle Thunderbirds,WHL,72,3,14,17,125,13,11528
2003-04,Jämtlands HF J20,J20 Elit,6,0,3,3,6,,4081
2003-04,Jämtlands HF,Division 1,24,3,6,9,20,,4081
2003-04,New England Jr. Coyotes,EJHL,39,19,25,44,120,,14875
2003-04,Deerfield Academy,USHS-Prep,23,6,4,10,22,,15066
2003-04,Neftekhimik Nizhnekamsk-2,Russia3,-,-,-,-,-,,12251
2003-04,Linköping HC,SHL,49,12,18,30,26,24,158
2003-04,Sweden,EHT,6,0,0,0,8,-1,158
2003-04,Sweden (all),International,10,1,0,1,10,,158
2003-04,Moose Jaw Warriors,WHL,72,18,20,38,40,-5,9191
2003-04,Sault Ste. Marie Greyhounds,OHL,63,16,26,42,28,-4,11535
2003-04,Team Southwest,USHS-MN,24,8,8,16,-,,15059
2003-04,Blake School,USHS-MN,27,31,24,55,4,,15059
2003-04,Team Northeast,USHS-MN,24,9,16,25,-,,18033
2003-04,Centennial High,USHS-MN,30,29,56,85,34,,18033
2003-04,Univ. of Maine,NCAA,44,3,16,19,34,,14077
2003-04,HK 95 Povazska Bystrica U18,Slovakia U18,10,14,10,24,31,21,18032
2003-04,HK 95 Povazska Bystrica,Slovakia2,29,11,9,20,30,5,18032
2003-04,Slovakia U18,WJC-18,6,7,1,8,6,6,18032
2003-04,VIK Hockey Ungdom J18,J18 Allsvenskan,14,12,15,27,6,,2495
2003-04,VIK Hockey Ungdom J20,J20 Elit,0,0,0,0,0,,2495
2003-04,VIK Hockey Ungdom,Allsvenskan,32,2,4,6,0,-3,2495
2003-04,Sweden U18,WJC-18,6,0,1,1,4,-3,2495
2003-04,Sweden U18 (all),International-Jr,20,2,5,7,4,,2495
2003-04,Prince Albert Raiders,WHL,71,3,6,9,190,-6,18031
2003-04,Mississauga IceDogs,OHL,68,17,25,42,25,23,15024
2003-04,Gatineau Olympiques,QMJHL,54,10,13,23,121,5,18030
2003-04,Gatineau Olympiques,M-Cup,5,4,1,5,0,4,18030
2003-04,Moose Jaw Warriors,WHL,72,15,22,37,139,5,10637
2003-04,Calgary Hitmen,WHL,71,5,27,32,49,14,10406
2003-04,Spokane Chiefs,WHL,72,19,14,33,65,-7,17817
2003-04,Chatham Jr. Maroons,WOHL,46,39,30,69,64,,11410
2003-04,Peterborough Petes,OHL,68,31,33,64,22,-7,9496
2003-04,Canada U18,WJC-18,7,6,1,7,6,5,9496
2003-04,HK Dukla Trencin,Slovakia,51,16,20,36,93,37,9665
2003-04,Slovakia,WC,9,0,0,0,2,1,9665
2003-04,Val-d'Or Foreurs,QMJHL,68,7,11,18,97,-6,12141
2003-04,Univ. of Notre Dame,NCAA,39,2,10,12,28,7,9480
2003-04,Canada U18,WJC-18,7,1,1,2,2,4,9480
2003-04,Canada U18,Hlinka Memorial,5,1,4,5,0,,9480
2003-04,HC Slavia Praha U20,Czech U20,55,25,35,60,112,6,9233
2003-04,HC Slavia Praha,Czech,1,0,0,0,0,-1,9233
2003-04,Czech Republic U18,WJC-18,7,3,2,5,8,6,9233
2003-04,Czech Republic U18 (all),International-Jr,13,5,7,12,8,,9233
2003-04,Czech Republic U19 (all),International-Jr,3,0,1,1,0,,9233
2003-04,Gottéron U20,Elite Jr. A,13,7,8,15,24,,9242
2003-04,HC Fribourg-Gottéron,NLA,42,2,3,5,14,,9242
2003-04,Switzerland U18,WJC-18 D1,5,7,2,9,0,7,9242
2003-04,Prince Albert Raiders,WHL,71,16,24,40,18,9,4131
2003-04,U.S. National U18 Team,NAHL,11,3,8,11,4,,9212
2003-04,U.S. National U18 Team,USDP,44,5,21,26,26,,9212
2003-04,USA U18,WJC-18,6,2,6,8,4,2,9212
2003-04,Windsor Spitfires,OHL,68,11,15,26,91,2,53546
2003-04,Kamloops Blazers,WHL,72,24,14,38,79,23,11671
2003-04,CSKA Moskva-2,Russia3,55,23,27,50,60,,12427
2003-04,Russian Selects,CHL Challenge,6,0,0,0,2,,12427
2003-04,HC Sparta Praha U20,Czech U20,21,10,10,20,16,9,9234
2003-04,HC Sparta Praha,Czech,13,0,0,0,0,-4,9234
2003-04,Czech Republic U18,WJC-18,7,1,1,2,2,2,9234
2003-04,Czech Republic U20,WJC-20,7,1,0,1,2,0,9234
2003-04,Czech Republic U18 (all),International-Jr,11,2,4,6,4,2,9234
2003-04,Czech Republic U20 (all),International-Jr,21,2,1,3,6,0,9234
2003-04,Prince Edward Island Rocket,QMJHL,70,21,22,43,51,7,11124
2003-04,Langley Hornets,BCHL,57,43,32,75,71,,15047
2003-04,Hotchkiss School,USHS-Prep,25,25,37,62,42,,11438
2003-04,Guelph Storm,OHL,68,36,32,68,86,17,9437
2003-04,Guelph Storm,M-Cup,3,1,1,2,8,1,9437
2003-04,Kitchener Rangers,OHL,68,15,36,51,28,4,9491
2003-04,Canada U18,WJC-18,7,1,1,2,4,0,9491
2003-04,Rimouski Océanic,QMJHL,45,7,18,25,30,20,23857
2003-04,London Knights,OHL,62,9,14,23,48,15,11326
2003-04,MODO Hockey J18,J18 Allsvenskan,3,3,1,4,2,,1950
2003-04,MODO Hockey J20,SuperElit,25,7,11,18,28,,1950
2003-04,MODO Hockey,SHL,24,1,2,3,6,-6,1950
2003-04,Sweden U18,WJC-18,6,3,1,4,0,-1,1950
2003-04,Sweden U18 (all),International-Jr,18,3,3,6,6,,1950
2003-04,Gatineau Olympiques,QMJHL,70,23,27,50,16,11,9228
2003-04,Lethbridge Hurricanes,WHL,68,16,33,49,85,-5,9486
2003-04,Canada U18,WJC-18,7,0,2,2,4,1,9486
2003-04,HC Zlin U20,Czech U20,52,18,33,51,104,11,9620
2003-04,HC Zlin,Czech,9,0,0,0,0,-1,9620
2003-04,Czech Republic U18,WJC-18,7,2,3,5,16,-1,9620
2003-04,Czech Republic U18 (all),International-Jr,12,7,5,12,20,-1,9620
2003-04,Avangard Omsk-2,Russia3,52,5,9,14,50,,12241
2003-04,Russian Selects,CHL Challenge,6,0,0,0,2,,12241
2003-04,HIFK U20,Jr. A SM-liiga,30,12,10,22,60,8,4130
2003-04,HIFK,Liiga,3,0,0,0,0,0,4130
2003-04,Suomi U20,Mestis,3,0,0,0,0,-3,4130
2003-04,Univ. of Wisconsin,NCAA,37,6,13,19,48,,9416
2003-04,USA U20,WJC-20,6,0,2,2,2,2,9416
2003-04,Sioux Falls Stampede,USHL,59,26,38,64,168,13,14182
2003-04,HC VTJ Telvis Topoľčany,Slovakia2,28,16,8,24,8,,9245
2003-04,Slovakia U18,WJC-18,6,2,0,2,4,1,9245
2003-04,Rimouski Océanic,QMJHL,50,4,11,15,194,-4,11526
2003-04,Tri-City Storm,USHL,43,4,20,24,78,23,15308
2003-04,Peterborough Petes,OHL,60,0,8,8,63,-18,11010
2003-04,Lukko,Liiga,55,21,15,36,73,13,4278
2003-04,Finland,EHT,4,1,0,1,0,,4278
2003-04,Medicine Hat Tigers,WHL,72,25,35,60,45,14,10876
2003-04,Medicine Hat Tigers,M-Cup,4,0,0,0,4,1,10876
2003-04,Plymouth Whalers,OHL,68,15,15,30,214,4,11351
2003-04,Neftekhimik Nizhnekamsk,Russia,45,6,11,17,26,11,9351
2003-04,Belarus U20,WJC-20 D1,5,4,5,9,0,7,9351
2003-04,Belarus,WC D1,5,2,1,3,8,6,9351
2003-04,Belarus (all),International,13,2,3,5,12,,9351
2003-04,Yunior Minsk,Belarus,4,0,1,1,6,,12191
2003-04,Dinamo Minsk,Belarus,43,0,4,4,28,,12191
2003-04,Dinamo Minsk-2,Belarus2,3,1,0,1,2,,12191
2003-04,Belarus U18,WJC-18,5,1,0,1,24,-4,12191
2003-04,Belarus U20,WJC-20 D1,5,0,2,2,6,1,12191
2003-04,Belarus (all),International,3,0,0,0,2,,12191
2003-04,Dinamo Minsk,Belarus Cup,3,0,0,0,6,,12191
2003-04,Oshawa Generals,OHL,56,0,7,7,41,-5,13615
2003-04,Northwood School Prep,USHS-Prep,40,32,34,66,22,,15057
2003-04,Västra Frölunda HC J18,J18 Allsvenskan,0,0,0,0,0,,1290
2003-04,Västra Frölunda HC J20,SuperElit,35,6,7,13,22,,1290
2003-04,Sweden U18,WJC-18,6,1,1,2,10,1,1290
2003-04,Sweden U18 (all),International-Jr,20,4,1,5,38,,1290
2003-04,Spartak Moskva-2,Russia3,-,-,-,-,-,,18029
2003-04,Kloten U20,Elite Jr. A,17,15,12,27,76,,17894
2003-04,Kloten Flyers,NLA,20,1,1,2,2,,17894
2003-04,GC Küsnacht Lions,NLB,6,4,0,4,6,,17894
2003-04,Lada Togliatti,Russia,23,1,0,1,12,3,9603
2003-04,Lada Togliatti-2,Russia3,10,1,1,2,4,,9603
2003-04,Mississauga IceDogs,OHL,30,0,4,4,89,1,12039
2003-04,Collingwood Blues,OPJHL,25,7,15,22,148,,12039
2003-04,Univ. of Michigan,NCAA,42,8,5,13,51,12,9412
2003-04,UMass-Lowell,NCAA,36,18,16,34,18,,10986
2003-04,Cape Breton Screaming Eagles,QMJHL,56,5,13,18,48,14,12166
2003-04,Guelph Storm,OHL,9,1,3,4,2,2,11324
2003-04,Toronto St. Michael's Majors,OHL,54,17,24,41,30,16,11324
2003-04,Northern Michigan Univ.,NCAA,36,1,6,7,30,-2,9417
2003-04,Kamloops Blazers,WHL,71,7,12,19,107,3,11694
2003-04,Grande Prairie Storm,AJHL,44,23,26,49,85,,14865
2003-04,Grande Prairie Storm,RBC Cup,5,2,6,8,4,,14865
2003-04,HC Davos,NLA,39,11,8,19,0,,9655
2003-04,Switzerland U20,WJC-20,5,3,3,6,0,3,9655
2003-04,Moncton Gagnon Beavers,MJAHL,42,3,2,5,235,,12131
2003-04,Halifax Mooseheads,QMJHL,1,0,0,0,5,1,12131
2003-04,Nanaimo Clippers,BCHL,58,23,26,49,73,,18028
2003-04,HK Spisska Nova Ves U20,Slovakia U20,37,20,24,44,102,,9252
2003-04,HK Spisska Nova Ves,Slovakia2,30,2,3,5,16,,9252
2003-04,Slovakia U18,WJC-18,6,0,3,3,6,1,9252
2003-04,Slovakia U19,International-Jr,2,1,2,3,0,5,9252
2003-04,Halifax Mooseheads,QMJHL,70,17,21,38,78,-12,9494
2003-04,Canada U18,WJC-18,7,1,4,5,18,3,9494
2003-04,U.S. National U18 Team,NAHL,10,1,2,3,8,,9427
2003-04,USA U18,WJC-18,6,2,3,5,8,1,9427
2003-04,Cape Breton Screaming Eagles,QMJHL,68,4,12,16,137,16,11740
2003-04,Univ. of Nebraska-Omaha,NCAA,39,16,19,35,52,,11414
2003-04,Calgary Hitmen,WHL,12,0,1,1,24,3,11601
2003-04,Tri-City Americans,WHL,23,3,1,4,33,-2,11601
2003-04,Peterborough Petes,OHL,67,14,14,28,124,-6,10990
2003-04,Kamloops Blazers,WHL,70,0,8,8,54,8,11308
2003-04,Vernon Vipers,BCHL,60,43,53,96,26,,11417
2003-04,HC Sparta Praha U20,Czech U20,37,3,6,9,36,1,9619
2003-04,HC Sparta Praha,Czech,1,0,0,0,0,0,9619
2003-04,Czech Republic U18,WJC-18,7,0,0,0,6,2,9619
2003-04,Czech Republic U19 (all),International-Jr,10,0,1,1,10,2,9619
2003-04,HC Vitkovice U20,Czech U20,52,4,11,15,44,0,9621
2003-04,Czech Republic U18,WJC-18,7,0,0,0,8,0,9621
2003-04,Czech Republic U18 (all),International-Jr,9,0,2,2,2,,9621
2003-04,Västra Frölunda HC J18,J18 Allsvenskan,0,0,0,0,0,,1255
2003-04,Västra Frölunda HC J20,SuperElit,36,9,6,15,67,,1255
2003-04,Sweden U18,WJC-18,6,0,4,4,12,1,1255
2003-04,Sweden U18 (all),International-Jr,16,3,5,8,22,,1255
2003-04,Texas Tornado,NAHL,54,5,27,32,93,,14859
2003-04,Cedar Rapids Roughriders,USHL,55,7,26,33,34,0,12367
2003-04,Univ. of Wisconsin,NCAA,42,14,13,27,46,,9414
2003-04,HC Vsetin U20,Czech U20,51,2,4,6,26,-2,18027
2003-04,HIFK U20,Jr. A SM-liiga,33,11,17,28,28,11,4279
2003-04,HIFK,Liiga,8,0,0,0,2,-1,4279
2003-04,Suomi U20,Mestis,7,1,0,1,0,-1,4279
2003-04,Finland U20,WJC-20,5,0,0,0,27,-1,4279
2003-04,Västra Frölunda HC J18,J18 Allsvenskan,0,0,0,0,0,,2034
2003-04,Västra Frölunda HC J20,SuperElit,28,7,10,17,14,,2034
2003-04,Sweden U18 (all),International-Jr,7,0,1,1,18,,2034
2003-04,Boston Univ.,NCAA,38,5,12,17,20,7,13482
2003-04,Saginaw Spirit,OHL,68,10,18,28,81,-22,9497
2003-04,Canada U18,WJC-18,7,2,1,3,8,2,9497
2003-04,Tappara U20,Jr. A SM-liiga,12,3,12,15,8,10,4281
2003-04,Tappara,Liiga,39,4,9,13,29,9,4281
2003-04,Suomi U20,Mestis,6,1,1,2,4,-7,4281
2003-04,Finland U20,WJC-20,7,1,1,2,2,1,4281
2003-04,Notre Dame Hounds,SJHL,55,20,44,64,12,,11449
2003-04,Shawinigan Cataractes,QMJHL,53,0,7,7,129,4,51401
2003-04,U.S. National U18 Team,NAHL,10,3,4,7,4,,9432
2003-04,U.S. National U18 Team,USDP,45,18,20,38,16,,9432
2003-04,USA U18,WJC-18,6,1,3,4,2,-1,9432
2003-04,Tri-City Americans,WHL,69,11,12,23,53,2,18026
2003-04,Bramalea Blues,OPJHL,33,3,12,15,16,,11585
2003-04,Brampton Battalion,OHL,2,1,1,2,0,-1,11585
2003-04,London Knights,OHL,51,3,5,8,48,9,11237
2003-04,TUTO Hockey U18,Jr. B SM-sarja,16,7,6,13,4,,4223
2003-04,TuTo Hockey,Mestis,25,4,3,7,2,-4,4223
2003-04,Finland U18,WJC-18,6,1,0,1,4,2,4223
2003-04,Sioux City Musketeers,USHL,60,20,20,40,119,4,18025
2003-04,Ottawa 67's,OHL,67,29,36,65,56,11,8955
2003-04,Québec Remparts,QMJHL,54,6,8,14,14,-14,11533
2003-04,HC Zlin U20,Czech U20,53,23,33,56,122,9,13659
2003-04,HC Zlin,Czech,4,1,0,1,2,0,13659
2003-04,Czech Republic U18,WJC-18,7,0,2,2,2,-2,13659
2003-04,Czech Republic U18 (all),International-Jr,16,1,4,5,2,-2,13659
2003-04,HC Örebro J20,J20 Elit,-,-,-,-,-,,2620
2003-04,HC Örebro 90,Allsvenskan,42,4,0,4,83,-26,2620
2003-04,Sweden U18,WJC-18,5,0,0,0,8,-2,2620
2003-04,Sweden U18 (all),International-Jr,14,1,0,1,18,,2620
2003-04,HV71 J20,SuperElit,18,9,3,12,42,,2018
2003-04,HV71,SHL,9,0,0,0,2,0,2018
2003-04,Cornell Univ.,NCAA,28,3,3,6,18,,12487
2003-04,Moose Jaw Warriors,WHL,72,23,26,49,111,15,10669
2003-04,Baie-Comeau Drakkar,QMJHL,62,2,3,5,198,-9,15208
2003-04,Surrey Eagles,BCHL,58,7,30,37,101,,11919
2003-04,Yunior Minsk,Belarus,30,5,3,8,26,,12248
2003-04,Yunost Minsk,Belarus,20,1,7,8,4,,12248
2003-04,Yunost Minsk-2,Belarus2,4,1,4,5,10,,12248
2003-04,Belarus U20,WJC-20 D1,5,0,1,1,4,1,12248
2003-04,Belarus (all),International,5,0,0,0,29,,12248
2003-04,Yunost Minsk,Belarus Cup,6,2,2,4,8,,12248
2003-04,Miami Univ. (Ohio),NCAA,34,1,0,1,66,-6,14564
2003-04,Lada Togliatti,Russia,59,2,5,7,50,9,18024
2003-04,Lada Togliatti-2,Russia3,4,0,1,1,29,,18024
2003-04,Peterborough Petes,OHL,66,15,30,45,52,-1,17820
2003-04,Red Deer Rebels,WHL,67,11,8,19,34,-5,11639
2003-04,Univ. of Michigan,NCAA,41,1,14,15,62,14,9418
2003-04,USA U20,WJC-20,6,0,0,0,0,2,9418
2003-04,New England Jr. Coyotes,EJHL,-,-,-,-,-,,15063
2003-04,Calgary Hitmen,WHL,72,6,13,19,28,0,14837
2003-04,Erie Otters,OHL,67,20,46,66,66,-3,9106
2003-04,OHL All-Stars,CHL Challenge,2,1,0,1,2,,9106
2003-04,Prince George Cougars,WHL,70,19,23,42,122,-1,9492
2003-04,Canada U18,WJC-18,7,2,1,3,6,-1,9492
2003-04,White Bear Lake High,USHS-MN,27,25,19,44,-,,18023
2003-04,Plymouth Whalers,OHL,63,18,28,46,83,0,18022
2003-04,Miami Univ. (Ohio),NCAA,41,21,14,35,22,4,14518
2003-04,Cornell Univ.,NCAA,31,6,1,7,14,,13480
2003-04,Coquitlam Express,BCHL,56,31,38,69,87,,11887
2003-04,Seattle Thunderbirds,WHL,63,21,15,36,29,18,9498
2003-04,Canada U18,WJC-18,7,0,3,3,10,3,9498
2003-04,Kelowna Rockets,WHL,72,6,12,18,47,1,10350
2003-04,Kelowna Rockets,M-Cup,4,1,1,2,2,1,10350
2003-04,Kelowna Rockets,WHL,49,8,16,24,24,7,11534
2003-04,Kelowna Rockets,M-Cup,4,0,0,0,4,0,11534
2003-04,CSKA Moskva,Russia,10,1,0,1,8,0,12300
2003-04,CSKA Moskva-2,Russia3,9,2,1,3,32,,12300
2003-04,Sault Ste. Marie Greyhounds,OHL,67,9,11,20,37,-11,11492
2003-04,Kelowna Rockets,WHL,72,25,21,46,44,16,12026
2003-04,Kelowna Rockets,M-Cup,4,1,1,2,4,0,12026
2003-04,Peterborough Petes,OHL,58,4,6,10,76,-10,14187
2003-04,Lewiston MAINEiacs,QMJHL,68,13,52,65,140,0,11881
2003-04,HC Ceské Budejovice U20,Czech U20,21,1,7,8,8,-1,18021
2003-04,HC Ceske Budejovice,Czech,15,0,1,1,8,-5,18021
2003-04,Univ. of Denver,NCAA,39,3,6,9,18,,14460
2003-04,Cedar Rapids Roughriders,USHL,35,1,7,8,23,-7,14856
2003-04,Chicago Steel,USHL,59,22,24,46,53,6,17616
2003-04,Halifax Mooseheads,QMJHL,69,16,15,31,45,-26,13652
2003-04,Czech Republic U20 (all),International-Jr,3,1,1,2,-,,13652
2003-04,Trail Smoke Eaters,BCHL,51,9,21,30,51,,18020
2003-04,Swift Current Broncos,WHL,70,3,14,17,79,14,9481
2003-04,Canada U18,WJC-18,6,0,0,0,4,0,9481
2003-04,Stocksunds IF J18,J18 Allsvenskan,14,5,5,10,14,,3841
2003-04,Sioux Falls Stampede,USHL,60,37,31,68,60,-4,14863
2003-04,Dynamo Moskva-2,Russia3,-,-,-,-,-,,13646
2003-04,THK Tver,Russia2,24,3,1,4,4,-2,13646
2003-04,Brown Univ.,NCAA,31,10,20,30,20,,18019
2003-04,LeKi U20,Jr. A Suomi-sarja,12,11,11,22,26,,4283
2003-04,LeKi,II-divisioona,22,19,19,38,30,,4283
2003-04,Team Southwest,USHS-MN,24,9,5,14,-,,15314
2003-04,Blake School,USHS-MN,28,22,30,52,20,,15314
2003-04,ZSC Lions,NLA,48,12,24,36,78,,4092
2003-04,Switzerland,WC,7,1,1,2,2,1,4092
2003-04,Switzerland (all),International,21,3,2,5,-,,4092
2003-04,Minnesota State Univ. (Mankato),NCAA,38,9,12,21,14,,11446
2003-04,JYP U20,Jr. A SM-liiga,10,3,2,5,2,0,4284
2003-04,JYP,Liiga,25,1,3,4,2,-3,4284
2003-04,Suomi U20,Mestis,2,0,1,1,0,1,4284
2003-04,Univ. of New Hampshire,NCAA,38,4,10,14,12,,11480
2003-04,HC Litvinov U20,Czech U20,53,38,51,89,110,19,9617
2003-04,HC Litvinov,Czech,7,0,0,0,2,,9617
2003-04,HC Most,Czech3,1,0,0,0,0,,9617
2003-04,Czech Republic U19 (all),International-Jr,3,0,0,0,2,,9617
2003-04,Salmon Arm Silverbacks,BCHL,42,0,7,7,160,,15046
2003-04,Gatineau Olympiques,QMJHL,38,6,12,18,85,30,18018
2003-04,Czech Republic U20,WJC-20,7,0,0,0,14,-2,18018
2003-04,Czech Republic U20 (all),International-Jr,11,0,1,1,40,,18018
2003-04,Gatineau Olympiques,M-Cup,5,0,3,3,4,5,18018
2003-04,Kärpät,Liiga,56,17,13,30,28,15,4285
2003-04,Finland,EHT,3,0,0,0,2,,4285
2003-04,Langley Hornets,BCHL,14,13,11,24,45,,15048
2003-04,Victoria Salsa,BCHL,12,5,7,12,77,,15048
2003-04,Powell River Kings,BCHL,19,7,18,25,94,,15048
2003-04,Nepean Raiders,CJHL,55,13,26,39,67,,15053
2003-04,Nepean Raiders,RBC Cup,5,2,3,5,4,,15053
2003-04,Colgate Univ.,NCAA,37,14,17,31,23,,11750
2003-04,London Knights,OHL,64,26,53,79,47,35,14326
2003-04,Salmon Arm Silverbacks,BCHL,57,14,40,54,117,,14874
2003-04,Shawinigan Cataractes,QMJHL,70,31,29,60,76,18,18017
2003-04,Baie-Comeau Drakkar,QMJHL,67,2,11,13,35,-17,16666
2003-04,Kootenay Ice,WHL,72,26,35,61,63,-2,14459
2003-04,Camrose Kodiaks,AJHL,42,20,36,56,31,,18016
2003-04,Cushing Academy,USHS-Prep,-,-,-,-,-,,41102
2003-04,Spartak Moskva-2,Russia3,-,-,-,-,-,,41103
2003-04,Green Bay Gamblers,USHL,57,1,6,7,141,-8,11920
2003-04,Västra Frölunda HC J18,J18 Allsvenskan,0,0,0,0,0,,1256
2003-04,Västra Frölunda HC J20,SuperElit,31,6,3,9,22,,1256
2003-04,Vancouver Giants,WHL,69,10,8,18,267,-16,10303
2003-04,Rødovre Mighty Bulls,Denmark,35,12,7,19,48,,2368
2003-04,Denmark U18,WJC-18,6,3,4,7,32,3,2368
2003-04,Denmark U20,WJC-20 D1,3,0,1,1,12,-1,2368
2003-04,New Jersey Jr. Titans,AtJHL,-,-,-,-,-,,15307
2003-04,Stocksunds IF J18,J18 Allsvenskan,12,1,6,7,26,-10,2277
2003-04,Brewster Bulldogs,EmJHL,29,16,30,46,52,,41104
2004-05,Rimouski Océanic,QMJHL,62,66,102,168,84,78,6146
2004-05,Canada U20,WJC-20,6,6,3,9,4,4,6146
2004-05,Rimouski Océanic,M-Cup,5,6,5,11,6,7,6146
2004-05,Owen Sound Attack,OHL,62,37,52,89,51,30,9210
2004-05,U.S. National U18 Team,NAHL,12,7,10,17,57,,9205
2004-05,U.S. National U18 Team,USDP,26,5,9,14,86,,9205
2004-05,USA U18,WJC-18,6,0,2,2,35,7,9205
2004-05,Sudbury Wolves,OHL,67,29,36,65,102,7,4229
2004-05,Vancouver Giants,WHL,70,39,48,87,169,4,10235
2004-05,Canada U18,JWC-18,5,3,0,3,14,,10235
2004-05,U.S. National U18 Team,NAHL,16,6,11,17,20,,9217
2004-05,U.S. National U18 Team,USDP,26,9,11,20,36,,9217
2004-05,USA U18,WJC-18,6,1,3,4,8,3,9217
2004-05,Saskatoon Blades,WHL,69,33,31,64,34,20,9360
2004-05,Canada U18,WJC-18,6,4,2,6,7,7,9360
2004-05,Moorhead High,USHS-MN,25,12,26,38,-,,9218
2004-05,Lincoln Stars,USHL,12,0,3,3,4,-1,9218
2004-05,USA U20,WJC-20,7,0,0,0,4,2,9218
2004-05,Val-d'Or Foreurs,QMJHL,70,13,19,32,117,-39,9185
2004-05,Canada U18,WJC-18,6,0,1,1,4,5,9185
2004-05,Canada U18,Hlinka Memorial,5,0,1,1,2,,9185
2004-05,Södertälje SK J18,J18 Allsvenskan,1,1,2,3,0,2,4233
2004-05,Södertälje SK J20,SuperElit,30,28,21,49,26,29,4233
2004-05,Södertälje SK,SHL,5,0,0,0,0,-1,4233
2004-05,Slovenia U18,WJC-18 D1,5,6,5,11,14,-1,4233
2004-05,Slovenia U20,WJC-20 D1,5,10,3,13,6,8,4233
2004-05,Slovenia,OGQ,3,1,1,2,2,0,4233
2004-05,Slovenia,WC,6,1,0,1,2,-6,4233
2004-05,Sudbury Wolves,OHL,65,6,20,26,53,22,9183
2004-05,Canada U18,Hlinka Memorial,5,0,0,0,2,,9183
2004-05,Chicoutimi Saguenéens,QMJHL,59,32,50,82,50,6,9248
2004-05,Slovakia U20,WJC-20,4,1,2,3,6,1,9248
2004-05,Cornell Univ.,NCAA,26,3,7,10,33,,9200
2004-05,Erie Otters,OHL,64,25,38,63,60,-4,9197
2004-05,Canada U18,WJC-18,6,5,0,5,12,4,9197
2004-05,Canada U18,Hlinka Memorial,5,3,2,5,20,,9197
2004-05,Lewiston MAINEiacs,QMJHL,65,31,55,86,172,27,10877
2004-05,HC Ceské Budejovice U20,Czech U20,37,22,22,44,80,7,9237
2004-05,HC Ceske Budejovice,Czech2,15,1,2,3,2,8,9237
2004-05,HC Ceske Budejovice,Czech Q,-,-,-,-,-,,9237
2004-05,Czech Republic U18,WJC-18,7,4,3,7,10,7,9237
2004-05,Czech Republic U18 (all),International-Jr,15,6,6,12,16,,9237
2004-05,Guelph Storm,OHL,66,2,17,19,36,5,9184
2004-05,Canada U18,WJC-18,6,0,0,0,6,2,9184
2004-05,Canada U18,Hlinka Memorial,5,1,2,3,12,,9184
2004-05,Kitchener Rangers,OHL,62,3,11,14,92,12,9230
2004-05,Czech Republic U20 (all),International-Jr,3,0,1,1,4,,9230
2004-05,Moose Jaw Warriors,WHL,70,37,37,74,122,-4,10440
2004-05,Kitchener Rangers,OHL,44,4,18,22,44,16,10302
2004-05,Södertälje SK J20,SuperElit,21,18,16,34,25,,2045
2004-05,Södertälje SK,SHL,25,1,0,1,2,2,2045
2004-05,Sweden U18,WJC-18,7,6,0,6,0,5,2045
2004-05,Sweden U18 (all),International-Jr,11,10,2,12,4,,2045
2004-05,Sweden U20,WJC-20,6,2,1,3,2,0,2045
2004-05,Sweden U20 (all),International-Jr,15,4,1,5,8,,2045
2004-05,Warroad High,USHS-MN,31,37,62,99,22,,9209
2004-05,Sioux Falls Stampede,USHL,11,3,2,5,6,-2,9209
2004-05,St. Michael's Buzzers,OPJHL,49,36,66,102,33,,9187
2004-05,St. Michael's Buzzers,Dudley Hewitt Cup,4,5,1,6,0,,9187
2004-05,Canada U18,Hlinka Memorial,5,4,5,9,22,,9187
2004-05,Sarnia Sting,OHL,31,1,5,6,74,-4,11249
2004-05,Sioux Falls Stampede,USHL,55,3,10,13,181,-18,12209
2004-05,Virginia/Mountain Iron-Buhl High,USHS-MN,29,27,38,65,34,,9214
2004-05,Windsor Spitfires,OHL,61,21,52,73,179,1,9186
2004-05,HC Presov U20,Slovakia U20,23,6,10,16,44,,9251
2004-05,PHK Preov,Slovakia2,32,3,1,4,24,,9251
2004-05,Slovakia U18,WJC-18,6,0,0,0,10,2,9251
2004-05,Portland Winter Hawks,WHL,70,5,10,15,60,-10,9355
2004-05,Canada U18,WJC-18,6,0,2,2,0,1,9355
2004-05,Plymouth Whalers,OHL,67,18,26,44,32,-5,9362
2004-05,Canada U18,WJC-18,6,1,1,2,6,-1,9362
2004-05,U.S. National U18 Team,NAHL,15,10,13,23,20,,9375
2004-05,U.S. National U18 Team,USDP,23,4,11,15,16,,9375
2004-05,USA U18,WJC-18,6,0,3,3,2,5,9375
2004-05,Québec Remparts,QMJHL,70,5,25,30,33,39,10218
2004-05,Shattuck St. Mary's Midget Prep,USHS-Prep,50,4,30,34,52,,9204
2004-05,U.S. National U18 Team,USDP,11,1,2,3,12,,9204
2004-05,USA U18,WJC-18,6,1,0,1,8,5,9204
2004-05,Seattle Thunderbirds,WHL,72,6,16,22,46,26,11619
2004-05,HC Vitkovice U20,Czech U20,39,20,11,31,161,1,9231
2004-05,HC Vitkovice,Czech,1,0,0,0,0,0,9231
2004-05,Czech Republic U18,WJC-18,7,0,3,3,12,4,9231
2004-05,Czech Republic U18 (all),International-Jr,15,1,4,5,18,,9231
2004-05,Czech Republic U20 (all),International-Jr,4,0,0,0,14,,9231
2004-05,Portland Winter Hawks,WHL,32,2,11,13,10,6,12385
2004-05,Cedar Rapids Roughriders,USHL,60,27,25,52,86,20,10460
2004-05,Erie Otters,OHL,61,22,19,41,75,-9,9195
2004-05,Univ. of Denver,NCAA,42,17,28,45,30,,10212
2004-05,Drummondville Voltigeurs,QMJHL,65,29,49,78,76,7,9194
2004-05,Canada U18,WJC-18,6,2,3,5,4,3,9194
2004-05,Calgary Hitmen,WHL,71,8,35,43,61,18,10432
2004-05,Ohio State Univ.,NCAA,42,11,34,45,38,,9221
2004-05,Kölner EC U18,DNL,7,4,5,9,18,,10612
2004-05,Kölner Haie,DEL,47,1,1,2,14,-4,10612
2004-05,Moskitos Essen,Germany2,3,0,0,0,0,,10612
2004-05,Germany U18,WJC-18,6,1,2,3,4,-1,10612
2004-05,Lewiston MAINEiacs,QMJHL,53,8,18,26,98,9,12386
2004-05,Rimouski Océanic,QMJHL,69,54,62,116,66,61,9475
2004-05,Rimouski Océanic,M-Cup,5,3,6,9,4,6,9475
2004-05,Camrose Kodiaks,AJHL,55,41,41,82,80,,11354
2004-05,Camrose Kodiaks,RBC Cup,5,4,6,10,2,,11354
2004-05,Seattle Thunderbirds,WHL,66,18,34,52,76,30,12388
2004-05,Surrey Eagles,BCHL,60,48,49,97,81,,12389
2004-05,Boston College,NCAA,38,9,8,17,58,,9196
2004-05,Canada U18,WJC-18,6,4,0,4,8,1,9196
2004-05,Sudbury Wolves,OHL,66,3,16,19,98,31,11321
2004-05,Lewiston MAINEiacs,QMJHL,19,4,4,8,8,1,10435
2004-05,Vancouver Giants,WHL,41,0,3,3,89,-9,12387
2004-05,Kamloops Blazers,WHL,28,3,0,3,83,-2,12387
2004-05,Univ. of Minnesota,NCAA,30,2,8,10,28,,9420
2004-05,USA U20,WJC-20,7,0,0,0,14,-3,9420
2004-05,Camrose Kodiaks,AJHL,58,8,28,36,40,,11600
2004-05,Camrose Kodiaks,RBC Cup,6,0,2,2,8,,11600
2004-05,Shattuck St. Mary's Midget Prep,USHS-Prep,66,56,50,106,104,,18014
2004-05,Val-d'Or Foreurs,QMJHL,70,13,19,32,79,-16,9189
2004-05,Canada U18,WJC-18,6,2,2,4,20,4,9189
2004-05,U.S. National U18 Team,USDP,54,7,12,19,176,,9374
2004-05,USNTDP Juniors,NAHL,13,2,4,6,50,,9374
2004-05,USA U18,WJC-18,6,0,1,1,4,0,9374
2004-05,Saskatoon Blades,WHL,72,30,32,62,73,11,12635
2004-05,Calgary Hitmen,WHL,70,14,11,25,111,-4,11452
2004-05,Medicine Hat Tigers,WHL,72,26,35,61,37,29,9188
2004-05,Canada U18,Hlinka Memorial,5,0,1,1,2,,9188
2004-05,Barrie Colts,OHL,10,3,7,10,13,3,11111
2004-05,Belleville Bulls,OHL,53,25,36,61,42,1,11111
2004-05,Medicine Hat Tigers,WHL,66,3,8,11,73,13,11670
2004-05,Lokomotiv Yaroslavl-2,Russia3,58,3,11,14,62,,9587
2004-05,Russia U18,WJC-18,6,1,1,2,12,0,9587
2004-05,Russia U18,Hlinka Memorial,5,1,1,2,6,2,9587
2004-05,Sarnia Sting,OHL,67,21,13,34,103,1,9364
2004-05,Canada U18,WJC-18,6,2,2,4,12,3,9364
2004-05,Canada U18,Hilinka Memorial,5,0,1,1,33,1,9364
2004-05,Kingston Frontenacs,OHL,67,32,28,60,58,-14,9622
2004-05,Peterborough Petes,OHL,68,29,53,82,55,27,10698
2004-05,Canada U18,Hilinka Memorial,5,0,1,1,8,0,10698
2004-05,Ilves U20,Jr. A SM-liiga,38,12,29,41,2,21,6423
2004-05,Ilves,Liiga,2,0,0,0,0,0,6423
2004-05,Finland U18,WJC-18,6,2,0,2,2,-3,6423
2004-05,St. George's School,USHS-Prep,20,26,24,50,-,,12384
2004-05,Saskatoon Blades,WHL,72,1,18,19,237,36,11252
2004-05,HIFK U18,Jr. B SM-sarja,0,0,0,0,0,,4417
2004-05,HIFK U20,Jr. A SM-liiga,20,5,4,9,18,1,4417
2004-05,HIFK,Liiga,15,0,2,2,2,0,4417
2004-05,Finland U18,WJC-18,6,0,0,0,8,-1,4417
2004-05,Finland U20,WJC-20,5,0,1,1,10,-3,4417
2004-05,Vancouver Giants,WHL,64,2,11,13,44,-10,10431
2004-05,Djurgårdens IF J20,SuperElit,30,21,13,34,49,,1299
2004-05,Djurgårdens IF,SHL,1,0,0,0,0,-1,1299
2004-05,London Knights,OHL,62,23,46,69,33,70,8900
2004-05,Canada U20,WJC-20,6,1,2,3,2,9,8900
2004-05,London Knights,M-Cup,4,1,4,5,2,6,8900
2004-05,Brampton Battalion,OHL,61,1,6,7,147,12,11264
2004-05,Blues U18,Jr. B SM-sarja,1,0,1,1,0,,5877
2004-05,Blues U20,Jr. A SM-liiga,37,6,9,15,38,-4,5877
2004-05,Blues,Liiga,1,0,0,0,0,0,5877
2004-05,Finland U18,WJC-18,6,2,3,5,2,1,5877
2004-05,Kitchener Rangers,OHL,58,0,8,8,96,3,11020
2004-05,Breck School,USHS-MN,28,49,38,87,14,,12208
2004-05,Prince Edward Island Rocket,QMJHL,68,10,29,39,48,-16,9356
2004-05,Canada U18,WJC-18,6,0,3,3,0,4,9356
2004-05,Univ. of Michigan,NCAA,39,23,32,55,24,19,9410
2004-05,USA U20,WJC-20,7,2,1,3,0,-2,9410
2004-05,Sault Ste. Marie Greyhounds,OHL,68,11,40,51,57,16,9363
2004-05,Canada U18,WJC-18,6,1,0,1,4,1,9363
2004-05,Plymouth Whalers,OHL,68,25,21,46,60,-2,9373
2004-05,U.S. National U18 Team,USDP,11,2,1,3,8,,9373
2004-05,USA U18,WJC-18,6,2,1,3,4,2,9373
2004-05,Moncton Wildcats,QMJHL,62,5,19,24,55,7,10449
2004-05,Latvia U20,WJC-20 D1,5,1,6,7,6,13,10449
2004-05,Latvia,WC,1,0,0,0,2,-1,10449
2004-05,Latvia (all),International,2,0,0,0,2,,10449
2004-05,HC Kosice U20,Slovakia U20,34,14,14,28,99,,10608
2004-05,HC Kosice,Slovakia,24,2,1,3,2,1,10608
2004-05,HK Trebisov,Slovakia2,1,0,0,0,0,,10608
2004-05,Slovakia U18,WJC-18,6,1,1,2,2,-3,10608
2004-05,Lewiston MAINEiacs,QMJHL,55,1,3,4,131,-2,15596
2004-05,HC Sparta Praha U20,Czech U20,38,2,7,9,42,17,9624
2004-05,Czech Republic U18,WJC-18,7,1,0,1,8,4,9624
2004-05,Mississauga IceDogs,OHL,66,11,17,28,103,5,9358
2004-05,Canada U18,WJC-18,4,0,0,0,4,-2,9358
2004-05,Canada U18,Hilinka Memorial,5,0,2,2,8,1,9358
2004-05,Sioux City Musketeers,USHL,60,6,22,28,90,36,9206
2004-05,Moorhead High,USHS-MN,30,35,32,67,28,,14870
2004-05,Lincoln Stars,USHL,7,1,4,5,0,1,14870
2004-05,Traktor Chelyabinsk,Russia2,40,9,8,17,36,6,9256
2004-05,Traktor Chelyabinsk-2,Russia3,1,0,0,0,0,,9256
2004-05,Russia U18,WJC-18,6,3,5,8,6,0,9256
2004-05,Russia U18,Hlinka Memorial,5,2,2,4,6,-1,9256
2004-05,Kitchener Rangers,OHL,59,20,30,50,41,2,10294
2004-05,Bowling Green State Univ.,NCAA,35,3,13,16,36,-2,9485
2004-05,Lincoln Stars,USHL,59,23,24,47,294,0,14076
2004-05,Red Deer Rebels,WHL,39,7,18,25,48,9,11041
2004-05,Moose Jaw Warriors,WHL,29,7,18,25,30,1,11041
2004-05,Frölunda HC J20,SuperElit,9,2,6,8,6,,2050
2004-05,Leksands IF J20,SuperElit,18,8,10,18,14,,2050
2004-05,Sweden U18,WJC-18,7,1,3,4,8,-3,2050
2004-05,Sweden U18 (all),International-Jr,16,3,6,9,10,,2050
2004-05,Sweden U19 (all),International-Jr,4,1,0,1,2,,2050
2004-05,New Hampshire Jr. Monarchs,EJHL,54,19,26,45,147,,14876
2004-05,Cushing Academy,USHS-Prep,34,14,40,54,52,,10247
2004-05,HC Slavia Praha U20,Czech U20,27,12,21,33,91,18,9227
2004-05,HC Slavia Praha,Czech,18,0,1,1,8,2,9227
2004-05,HC Havlickuv Brod,Czech3,7,3,0,3,31,,9227
2004-05,HC Havlickuv Brod,Czech2 Q,-,-,-,-,-,,9227
2004-05,Czech Republic U18,WJC-18,7,1,0,1,10,3,9227
2004-05,Czech Republic U18 (all),International-Jr,7,1,0,1,10,,9227
2004-05,Czech Republic U20 (all),International-Jr,3,0,0,0,0,,9227
2004-05,Saginaw Spirit,OHL,57,18,30,48,14,-5,9199
2004-05,Canada U18,WJC-18,6,2,3,5,2,4,9199
2004-05,HV71 J18,J18 Allsvenskan,3,0,2,2,4,,2640
2004-05,HV71 J20,SuperElit,31,4,11,15,87,,2640
2004-05,HV71,SHL,14,0,0,0,0,-2,2640
2004-05,Sweden U18,WJC-18,7,1,4,5,6,-1,2640
2004-05,Sweden U18 (all),International-Jr,16,3,5,8,6,,2640
2004-05,Sweden U19 (all),International-Jr,4,0,1,1,0,,2640
2004-05,HV71,ECC,2,0,0,0,0,0,2640
2004-05,Univ. of Denver,NCAA,42,2,5,7,78,,15044
2004-05,Portland Winter Hawks,WHL,67,11,22,33,116,1,11674
2004-05,Vancouver Giants,WHL,66,6,7,13,213,-16,11594
2004-05,Miami Univ. (Ohio),NCAA,38,14,11,25,30,,9211
2004-05,SaiPa U20,Jr. A SM-liiga,13,2,4,6,24,0,4224
2004-05,SaiPa,Liiga,29,1,1,2,8,-5,4224
2004-05,Finland U20,WJC-20,6,1,0,1,2,-3,4224
2004-05,Québec Remparts,QMJHL,64,40,26,66,108,28,11568
2004-05,Traktor Chelyabinsk,Russia2,42,11,5,16,24,10,18013
2004-05,Traktor Chelyabinsk-2,Russia3,1,0,0,0,0,,18013
2004-05,Russia U18,WJC-18,4,0,2,2,2,-1,18013
2004-05,Russia U18,Hlinka Memorial,5,0,2,2,6,-1,18013
2004-05,Saginaw Spirit,OHL,66,7,26,33,31,-29,10433
2004-05,Canada U18,Ivan Hilinka,5,1,1,2,2,8,10433
2004-05,Prince Edward Island Rocket,QMJHL,64,25,34,59,57,-2,4126
2004-05,Russia U18,WJC-18,6,0,1,1,6,-2,4126
2004-05,HK Skalica U18,Slovakia U18,3,1,7,8,2,,9250
2004-05,HK Skalica U20,Slovakia U20,30,17,18,35,40,,9250
2004-05,HK 36 Skalica,Slovakia,46,6,6,12,16,-4,9250
2004-05,Slovakia U18,WJC-18,6,0,7,7,12,1,9250
2004-05,Frölunda HC J18,J18 Allsvenskan,2,1,2,3,0,,2613
2004-05,Frölunda HC J20,SuperElit,32,7,14,21,14,,2613
2004-05,Denmark U18,WJC-18,6,2,2,4,2,-4,2613
2004-05,Denmark U20,WJC-20 D1,5,2,2,4,6,-2,2613
2004-05,Slovakia U18,WJC-18,6,4,1,5,10,2,9661
2004-05,Kamloops Blazers,WHL,69,12,35,47,18,-15,13618
2004-05,Kärpät U18,Jr. B SM-sarja,1,0,0,0,0,,7537
2004-05,Kärpät U20,Jr. A SM-liiga,36,9,11,20,16,1,7537
2004-05,Finland U18,WJC-18,6,0,0,0,4,-2,7537
2004-05,Victoria Salsa,BCHL,36,20,18,38,22,,14857
2004-05,Surrey Eagles,BCHL,20,3,9,12,8,,14857
2004-05,Kingston Frontenacs,OHL,67,11,14,25,92,-2,11309
2004-05,Lewiston MAINEiacs,QMJHL,49,19,26,45,24,10,12486
2004-05,Medicine Hat Tigers,WHL,72,10,14,24,27,6,10438
2004-05,Chicoutimi Saguenéens,QMJHL,53,18,72,90,42,0,9247
2004-05,Slovakia U20,WJC-20,6,1,1,2,4,1,9247
2004-05,Notre Dame Hounds,SJHL,41,5,12,17,207,,15316
2004-05,HC Trinec U20,Czech U20,38,19,18,37,44,-1,9623
2004-05,HC Trinec,Czech,14,0,0,0,0,-6,9623
2004-05,Czech Republic U18,WJC-18,7,0,2,2,4,0,9623
2004-05,Czech Republic U18 (all),International-Jr,12,2,3,5,8,,9623
2004-05,HC Zlin U20,Czech U20,38,9,8,17,38,10,9232
2004-05,HC Zlin,Czech,4,0,0,0,6,1,9232
2004-05,Czech Republic U18,WJC-18,7,0,4,4,6,6,9232
2004-05,Czech Republic U18 (all),International-Jr,12,2,4,6,20,,9232
2004-05,IFK Kumla,Division 1,29,20,18,38,14,23,4120
2004-05,IFK Arboga,Allsvenskan,2,0,0,0,0,-4,4120
2004-05,Sweden U19 (all),International-Jr,4,1,0,1,0,,4120
2004-05,Chilliwack Chiefs,BCHL,60,27,30,57,94,,15045
2004-05,Malmö Redhawks J20,SuperElit,31,8,14,22,104,,1288
2004-05,Malmö Redhawks,SHL,8,0,1,1,0,1,1288
2004-05,Sweden U19 (all),International-Jr,8,1,1,2,12,,1288
2004-05,Colorado College,NCAA,38,7,23,30,52,,11406
2004-05,U.S. National U18 Team,USDP,26,6,11,17,48,,9216
2004-05,U.S. National U18 Team,NAHL,12,7,5,12,25,0,9216
2004-05,USA U18,WJC-18,6,4,4,8,14,7,9216
2004-05,Moose Jaw Warriors,WHL,51,14,32,46,49,-6,3209
2004-05,Finland U20,WJC-20,6,0,0,0,12,-6,3209
2004-05,New England Jr. Falcons,EJHL,50,12,28,40,51,,14684
2004-05,Södertälje SK J20,SuperElit,5,1,2,3,4,,2021
2004-05,Owen Sound Attack,OHL,66,1,12,13,83,17,11234
2004-05,Lada Togliatti,Russia,15,1,0,1,4,-1,10490
2004-05,Lada Togliatti-2,Russia3,13,6,7,13,4,,10490
2004-05,Russia U18,WJC-18,6,0,3,3,8,-3,10490
2004-05,Russia U18,Hlinka Memorial,4,0,1,1,29,2,10490
2004-05,Ottawa 67's,OHL,68,6,24,30,44,26,11392
2004-05,Ottawa 67's,M-Cup,4,1,0,1,0,-2,11392
2004-05,Windsor Spitfires,OHL,68,23,50,73,16,9,11360
2004-05,Prince Albert Raiders,WHL,67,3,19,22,66,2,11645
2004-05,London Knights,OHL,65,9,13,22,159,32,12428
2004-05,London Knights,M-Cup,4,0,0,0,0,12,12428
2004-05,Boston Jr. Bruins,EJHL,53,17,25,42,170,,18012
2004-05,Saskatoon Blades,WHL,70,22,45,67,70,23,11593
2004-05,Noble & Greenough School,USHS-Prep,24,1,17,18,16,,18011
2004-05,Brandon Wheat Kings,WHL,64,7,9,16,79,-5,14003
2004-05,Frölunda HC J18,J18 Allsvenskan,2,1,2,3,10,,1715
2004-05,Frölunda HC J20,SuperElit,24,9,8,17,32,,1715
2004-05,Sweden U18,WJC-18,7,1,2,3,6,-1,1715
2004-05,Sweden U18 (all),International-Jr,16,5,5,10,14,,1715
2004-05,Sweden U19 (all),International-Jr,4,0,2,2,4,,1715
2004-05,Kärpät U20,Jr. A SM-liiga,36,5,12,17,73,13,4418
2004-05,Finland U20,WJC-20,6,0,1,1,10,-1,4418
2004-05,Vernon Vipers,BCHL,60,36,38,74,53,,14871
2004-05,UMass (Amherst),NCAA,38,13,12,25,28,,17767
2004-05,HC Slavia Praha U20,Czech U20,8,6,4,10,8,3,8640
2004-05,Saginaw Spirit,OHL,53,25,37,62,14,-3,8640
2004-05,Czech Republic U20,WJC-20,7,2,3,5,0,4,8640
2004-05,Czech Republic U20 (all),International-Jr,7,2,3,5,0,4,8640
2004-05,Spartak St. Petersburg,Russia2,51,0,3,3,74,-11,18010
2004-05,Spokane Chiefs,WHL,67,1,4,5,78,-13,11634
2004-05,U.S. National U18 Team,USDP,26,1,7,8,31,,9377
2004-05,USNTDP Juniors,NAHL,16,4,3,7,33,,9377
2004-05,USA U18,WJC-18,6,0,1,1,29,0,9377
2004-05,Prince Albert Raiders,WHL,40,2,1,3,93,-10,11650
2004-05,Spokane Chiefs,WHL,71,2,14,16,36,4,10459
2004-05,Prince George Cougars,WHL,72,18,38,56,24,-1,11637
2004-05,HC Liberec U20,Czech U20,45,16,20,36,58,14,10604
2004-05,Czech Republic U18 (all),International-Jr,8,1,0,1,8,,10604
2004-05,MODO Hockey J20,SuperElit,33,10,5,15,78,,2046
2004-05,Sweden U18,WJC-18,7,1,0,1,8,1,2046
2004-05,Sweden U18 (all),International-Jr,20,4,0,4,49,,2046
2004-05,Red Deer Rebels,WHL,53,0,2,2,117,-13,11646
2004-05,Ilves U18,Jr. B SM-sarja,1,1,0,1,0,,6424
2004-05,Ilves U20,Jr. A SM-liiga,38,2,9,11,32,18,6424
2004-05,Finland U18,WJC-18,6,1,1,2,4,-2,6424
2004-05,Harvard Univ.,NCAA,30,10,9,19,20,,11553
2004-05,Regina Pats,WHL,67,2,9,11,198,-22,19378
2004-05,Lake of the Woods High,USHS-MN,21,23,25,48,38,,15313
2004-05,Borderland Thunder,SIJHL,6,2,5,7,0,,15313
2004-05,Kootenay Ice,WHL,70,8,11,19,70,0,11630
2004-05,Salmon Arm Silverbacks,BCHL,51,6,36,42,78,,15054
2004-05,Sioux City Musketeers,USHL,54,30,31,61,112,26,11412
2004-05,Ottawa 67's,OHL,68,6,26,32,65,22,18009
2004-05,Ottawa 67's,M-Cup,4,0,2,2,2,0,18009
2004-05,Plymouth Whalers,OHL,66,0,6,6,93,1,12429
2004-05,Notre Dame Hounds,SJHL,50,2,15,17,28,,14864
2004-05,Lokomotiv Yaroslavl,Russia,1,0,0,0,2,0,15679
2004-05,Lokomotiv Yaroslavl-2,Russia3,30,6,12,18,82,,15679
2004-05,Russia U20,WJC-20,6,0,1,1,4,4,15679
2004-05,Russian Selects,CHL Challenge,6,0,2,2,14,,15679
2004-05,Salavat Yulaev Ufa,Russia,5,0,0,0,4,-1,9257
2004-05,Salavat Yulaev Ufa-2,Russia3,35,2,5,7,48,,9257
2004-05,Russia U18,WJC-18,6,1,1,2,4,-3,9257
2004-05,Russia U18,Hlinka Memorial,5,0,0,0,2,-1,9257
2004-05,Sioux City Musketeers,USHL,59,1,24,25,146,22,14873
2004-05,Frölunda HC J18,J18 Allsvenskan,1,0,0,0,4,,2627
2004-05,Frölunda HC J20,SuperElit,30,18,12,30,6,,2627
2004-05,Guelph Storm,OHL,59,24,22,46,29,0,11721
2004-05,Krylia Sovetov,Russia2,26,4,1,5,14,6,9261
2004-05,Krylia Sovetov Moskva-2,Russia3,15,6,6,11,22,,9261
2004-05,Russia U18,WJC-18,6,3,4,7,4,2,9261
2004-05,Russia U18,Hlinka Memorial,5,0,1,1,6,1,9261
2004-05,Chicoutimi Saguenéens,QMJHL,69,13,26,39,31,-4,11306
2004-05,Wayzata High,USHS-MN,24,27,36,63,-,,18008
2004-05,Omaha Lancers,USHL,11,1,0,1,0,2,18008
2004-05,Shawinigan Cataractes,QMJHL,70,5,20,25,96,0,9354
2004-05,Canada U18,WJC-18,6,0,0,0,2,-1,9354
2004-05,Sioux Falls Stampede,USHL,53,11,20,31,62,-4,15069
2004-05,Sarnia Sting,OHL,67,2,20,22,128,-30,11327
2004-05,U.S. National U18 Team,USDP,46,5,21,26,8,,9380
2004-05,USNTDP Juniors,NAHL,8,1,3,4,0,,9380
2004-05,USA U18,WJC-18,6,1,1,2,0,3,9380
2004-05,Chilliwack Chiefs,BCHL,5,1,0,1,2,,11586
2004-05,Tri-City Americans,WHL,35,0,0,0,61,-4,11586
2004-05,HK Gomel,Belarus,40,4,10,14,24,,9653
2004-05,HK Gomel-2,Belarus2,6,2,3,5,34,,9653
2004-05,Belarus U18,WJC-18 D1,4,1,5,6,4,5,9653
2004-05,Belarus U20,WJC-20,6,0,0,0,2,-6,9653
2004-05,HK Gomel,Belarus Cup,10,2,1,3,4,,9653
2004-05,Peterborough Petes,OHL,68,15,33,48,100,-6,15540
2004-05,HC Ceské Budejovice U20,Czech U20,42,12,28,40,142,15,10476
2004-05,HC Ceske Budejovice,Czech2,1,0,0,0,0,0,10476
2004-05,Czech Republic U18,WJC-18,7,3,2,5,6,5,10476
2004-05,Spokane Chiefs,WHL,72,10,27,37,47,-7,9357
2004-05,Canada U18,WJC-18,6,1,2,3,4,2,9357
2004-05,Upper Canada College,CISAA,35,24,22,46,24,,15312
2004-05,HK Dubnica U18,Slovakia U18,14,5,8,13,45,,11598
2004-05,HK Dubnica U20,Slovakia U20,36,22,17,39,38,,11598
2004-05,HK Dubnica,Slovakia,19,0,0,0,14,-14,11598
2004-05,Slovakia U18,WJC-18,6,1,0,1,0,0,11598
2004-05,Sioux City Musketeers,USHL,57,8,24,32,92,16,18007
2004-05,Spokane Chiefs,WHL,67,1,8,9,238,1,12426
2004-05,New England Jr. Falcons,EJHL,49,8,16,24,105,,15451
2004-05,CSKA Moskva-2,Russia3,-,-,-,-,-,,13643
2004-05,Brampton Battalion,OHL,65,25,46,71,80,10,15595
2004-05,Kootenay Ice,WHL,66,32,21,53,18,27,11056
2004-05,Boston Little Bruins,USAAA,38,27,20,47,44,,18006
2004-05,Worcester Academy,USHS-Prep,-,19,44,63,-,,18006
2004-05,Oshawa Generals,OHL,10,0,1,1,21,-2,18005
2004-05,Windsor Spitfires,OHL,44,0,2,2,134,-4,18005
2004-05,Seattle Thunderbirds,WHL,72,4,9,13,106,4,11616
2004-05,Chicago Steel,USHL,56,10,15,25,270,0,15050
2004-05,Skövde IK,Allsvenskan,41,9,9,18,34,-10,4152
2004-05,Sweden U19 (all),International-Jr,4,0,3,3,6,,4152
2004-05,Sweden U20,WJC-20,5,0,0,0,2,-3,4152
2004-05,Sweden U20 (all),International-Jr,13,1,1,2,4,,4152
2004-05,Omaha Lancers,USHL,60,24,33,57,16,10,11430
2004-05,IF Björklöven J20,J20 Elit,-,-,-,-,-,,2019
2004-05,IF Björklöven,Allsvenskan,9,0,0,0,0,-2,2019
2004-05,Sweden U18 (all),International-Jr,3,0,0,0,0,,2019
2004-05,CSKA Moskva,Russia,11,1,1,2,16,1,9263
2004-05,CSKA Moskva-2,Russia3,-,-,-,-,-,,9263
2004-05,Russian Selects,CHL Challenge,6,1,1,2,14,,9263
2004-05,Fort McMurray Oil Barons,AJHL,62,25,24,49,14,,15042
2004-05,Swift Current Broncos,WHL,57,2,4,6,102,-14,18004
2004-05,Kelowna Rockets,WHL,72,4,36,40,47,4,10405
2004-05,Kelowna Rockets,M-Cup,3,0,1,1,2,-1,10405
2004-05,Waterloo Black Hawks,USHL,51,18,18,36,56,4,14862
2004-05,Blake School,USHS-MN,28,6,16,22,38,,18003
2004-05,Brampton Battalion,OHL,63,1,4,5,64,0,11256
2004-05,Thayer Academy,USHS-Prep,31,8,12,20,24,,11884
2004-05,Des Moines Buccaneers,USHL,57,31,40,71,32,-10,9371
2004-05,U.S. National U18 Team,USDP,11,2,0,2,2,,9371
2004-05,USA U18,WJC-18,6,1,0,1,0,2,9371
2004-05,Salisbury School,USHS-Prep,26,1,4,5,10,,15055
2004-05,Väsby IK,Division 1,28,12,12,24,36,,3683
2004-05,Djurgårdens IF J20,SuperElit,5,3,0,3,2,,3683
2004-05,Sweden U18,WJC-18,7,1,0,1,2,0,3683
2004-05,Sweden U18 (all),International-Jr,12,2,1,3,2,,3683
2005-06,U.S. National U18 Team,USDP,36,12,22,34,78,,9207
2005-06,U.S. National U18 Team,NAHL,11,4,11,15,10,,9207
2005-06,USA U18,WJC-18,6,4,6,10,27,6,9207
2005-06,USA U20,WJC-20,7,1,3,4,18,-4,9207
2005-06,Peterborough Petes,OHL,68,28,40,68,69,16,10157
2005-06,Peterborough Petes,M-Cup,4,0,1,1,6,0,10157
2005-06,Canada U18,Hlinka Memorial,5,1,1,2,12,,10157
2005-06,Univ. of North Dakota,NCAA,42,22,17,39,22,22,8792
2005-06,Canada U20,WJC-20,6,0,2,2,2,2,8792
2005-06,Brynäs IF J20,SuperElit,0,0,0,0,0,,3682
2005-06,Brynäs IF,SHL,46,10,16,26,30,-1,3682
2005-06,Sweden U20,WJC-20,6,4,3,7,2,3,3682
2005-06,Sweden U20 (all),International-Jr,11,5,6,11,2,,3682
2005-06,Sweden,EHT,4,1,1,2,2,0,3682
2005-06,Sweden,WC,4,0,0,0,0,0,3682
2005-06,Sweden (all),International,9,1,2,3,2,0,3682
2005-06,Univ. of Minnesota,NCAA,39,18,33,51,28,24,8793
2005-06,USA U20,WJC-20,7,1,10,11,2,0,8793
2005-06,USA,WC,7,1,1,2,2,2,8793
2005-06,Drummondville Voltigeurs,QMJHL,58,44,72,116,92,19,9366
2005-06,Des Moines Buccaneers,USHL,50,27,31,58,56,28,10458
2005-06,Everett Silvertips,WHL,52,26,32,58,44,4,9220
2005-06,USA U20,WJC-20,7,2,4,6,26,1,9220
2005-06,Cape Breton Screaming Eagles,QMJHL,66,30,54,84,78,3,11121
2005-06,HC Kladno U20,Czech U20,3,1,2,3,0,1,8701
2005-06,HC Kladno,Czech,48,2,7,9,32,-8,8701
2005-06,Czech Republic U18,WJC-18,7,2,3,5,10,0,8701
2005-06,Czech Republic U18 (all),International-Jr,8,2,3,5,10,0,8701
2005-06,Czech Republic U20,WJC-20,6,0,1,1,4,-1,8701
2005-06,Czech Republic U20 (all),International-Jr,11,0,1,1,4,,8701
2005-06,Barrie Colts,OHL,64,42,67,109,99,26,10426
2005-06,HC Kladno U20,Czech U20,6,4,2,6,2,0,8605
2005-06,HC Kladno,Czech,44,7,3,10,51,-15,8605
2005-06,Czech Republic U18,WJC-18,7,4,3,7,8,2,8605
2005-06,Czech Republic U18 (all),International-Jr,12,4,3,7,10,,8605
2005-06,Czech Republic U20,WJC-20,4,0,0,0,0,-2,8605
2005-06,Czech Republic U20 (all),International-Jr,8,1,0,1,0,,8605
2005-06,Spokane Chiefs,WHL,67,36,14,50,28,-2,8494
2005-06,Prince George Cougars,WHL,70,5,32,37,68,12,9332
2005-06,Canada U18,WJC-18,7,0,0,0,14,-1,9332
2005-06,Canada U18,JWC-18,5,0,0,0,16,,9332
2005-06,Des Moines Buccaneers,USHL,56,35,40,75,69,25,10461
2005-06,Kingston Frontenacs,OHL,62,37,50,87,118,19,10442
2005-06,Univ. of Michigan,NCAA,39,0,10,10,59,5,9219
2005-06,USA U20,WJC-20,7,0,0,0,27,-1,9219
2005-06,Apple Valley High,USHS-MN,28,8,31,39,22,,11984
2005-06,Owen Sound Attack,OHL,68,14,51,65,44,-6,11110
2005-06,Gatineau Olympiques,QMJHL,69,39,64,103,64,30,10437
2005-06,VIK Hockey Ungdom J20,SuperElit,28,11,15,26,22,,4568
2005-06,VIK Västerås HK,Allsvenskan,19,0,2,2,6,-4,4568
2005-06,Sweden U18,WJC-18,6,1,5,6,8,1,4568
2005-06,Sweden U18 (all),International-Jr,21,2,7,9,18,,4568
2005-06,VIK Hockey Ungdom J20,SuperElit,27,17,12,29,38,,3637
2005-06,VIK Västerås HK,Allsvenskan,21,3,1,4,4,-4,3637
2005-06,Sweden U18,WJC-18,6,4,1,5,2,0,3637
2005-06,Sweden U18 (all),International-Jr,20,8,3,11,14,,3637
2005-06,Sweden U19 (all),International-Jr,4,0,0,0,0,,3637
2005-06,Rouyn-Noranda Huskies,QMJHL,54,13,35,48,57,1,11890
2005-06,Sudbury Wolves,OHL,65,24,46,70,146,19,10675
2005-06,U.S. National U18 Team,USDP,42,4,9,13,67,,9317
2005-06,U.S. National U18 Team,NAHL,17,2,2,4,20,,9317
2005-06,USA U18,WJC-18,6,1,0,1,37,5,9317
2005-06,Saginaw Spirit,OHL,61,6,24,30,172,2,9331
2005-06,Canada U18,WJC-18,7,0,0,0,28,0,9331
2005-06,HC Vitkovice U20,Czech U20,5,4,3,7,16,9,9236
2005-06,HC Vitkovice,Czech,42,5,9,14,50,4,9236
2005-06,Czech Republic U20,WJC-20,6,2,0,2,6,0,9236
2005-06,Czech Republic U20 (all),International-Jr,14,4,1,5,14,,9236
2005-06,Brainerd High,USHS-MN,26,14,23,37,34,,11431
2005-06,Lincoln Stars,USHL,13,1,3,4,9,3,11431
2005-06,Krylia Sovetov Moskva,Russia2,35,9,7,16,20,5,9591
2005-06,Krylia Sovetov Moskva-2,Russia3,12,5,8,13,14,,9591
2005-06,Russian Selects,CHL Challenge,6,2,1,3,0,-2,9591
2005-06,Baie-Comeau Drakkar,QMJHL,69,33,69,102,66,-6,9341
2005-06,Canada U18,WJC-18,7,3,5,8,6,-2,9341
2005-06,Ottawa 67's,OHL,65,26,31,57,113,-11,9336
2005-06,Canada U18,WJC-18,7,2,1,3,10,-2,9336
2005-06,Canada U18,JWC-18,5,0,0,0,12,,9336
2005-06,Severstal Cherepovets,Russia,37,1,0,1,18,0,9297
2005-06,Severstal Cherepovets-2,Russia3,2,0,0,0,4,,9297
2005-06,Russia U18,WJC-18,6,1,2,3,10,7,9297
2005-06,Russia U18,Hlinka Memorial,5,2,0,2,2,2,9297
2005-06,Halifax Mooseheads,QMJHL,34,14,11,25,54,-8,11985
2005-06,Sioux Falls Stampede,USHL,58,29,30,59,16,13,11448
2005-06,Everett Silvertips,WHL,51,21,14,35,26,4,9625
2005-06,Czech Republic U20 (all),International-Jr,3,1,0,1,27,,9625
2005-06,Kingston Frontenacs,OHL,66,26,64,90,32,37,9348
2005-06,Canada U18,WJC-18,7,1,1,2,2,2,9348
2005-06,Canada U18,JWC-18,5,1,0,1,2,,9348
2005-06,U.S. National U18 Team,USDP,39,8,14,22,52,,9323
2005-06,U.S. National U18 Team,NAHL,16,4,4,8,4,,9323
2005-06,USA U18,WJC-18,6,0,3,3,4,4,9323
2005-06,Moose Jaw Warriors,WHL,64,19,38,57,46,35,11059
2005-06,Metallurg Magnitogorsk,Russia,31,5,7,12,8,8,9258
2005-06,Metallurg Magnitogorsk-2,Russia3,4,3,1,4,4,,9258
2005-06,Russia U20,WJC-20,4,4,2,6,25,3,9258
2005-06,Russia,EHT,4,0,2,2,0,,9258
2005-06,Russia,WC,7,1,3,4,2,5,9258
2005-06,Des Moines Buccaneers,USHL,48,1,14,15,68,6,12265
2005-06,Belleville Bulls,OHL,67,13,21,34,42,-9,9345
2005-06,Canada U18,WJC-18,7,1,0,1,2,2,9345
2005-06,Québec Remparts,QMJHL,61,6,18,24,202,4,12266
2005-06,Québec Remparts,M-Cup,4,1,1,2,6,2,12266
2005-06,Kootenay Ice,WHL,69,28,32,60,52,17,9337
2005-06,Canada U18,WJC-18,7,2,5,7,10,3,9337
2005-06,Vancouver Giants,WHL,62,9,10,19,149,4,11104
2005-06,Vancouver Giants,M-Cup,5,0,0,0,15,-3,11104
2005-06,U.S. National U17 Team,USDP,3,0,1,1,4,,9310
2005-06,U.S. National U18 Team,USDP,37,3,5,8,36,,9310
2005-06,U.S. National U18 Team,NAHL,19,3,4,7,23,,9310
2005-06,USA U18,WJC-18,6,0,0,0,18,2,9310
2005-06,Coquitlam Express,BCHL,57,10,24,34,81,,10656
2005-06,Coquitlam Express,Doyle Cup,6,5,0,5,15,,10656
2005-06,Coquitlam Express,RBC Cup,6,3,2,5,18,,10656
2005-06,Acadie-Bathurst Titan,QMJHL,67,18,51,69,122,20,11891
2005-06,Lokomotiv Yaroslavl-2,Russia3,32,15,12,27,28,,9300
2005-06,Lokomotiv Yaroslavl,Russia,10,0,1,1,4,-1,9300
2005-06,Russia U18,WJC-18,6,3,2,5,2,3,9300
2005-06,Russia U18,Hlinka Memorial,5,1,2,3,2,5,9300
2005-06,Lada Togliatti,Russia,35,2,2,4,42,-10,9262
2005-06,Russia U20,WJC-20,6,0,3,3,2,3,9262
2005-06,Lada Togliatti,Continental Cup,3,0,0,0,0,-1,9262
2005-06,Lada Togliatti,Continental Cup,3,1,1,2,2,1,9262
2005-06,U.S. National U18 Team,USDP,41,12,14,26,38,,9312
2005-06,U.S. National U18 Team,NAHL,13,6,9,15,30,,9312
2005-06,USA U18,WJC-18,6,1,4,5,8,1,9312
2005-06,Windsor Spitfires,OHL,68,5,21,26,181,17,11231
2005-06,Lokomotiv Yaroslavl-2,Russia3,29,29,6,35,14,,9305
2005-06,Lokomotiv Yaroslavl,Russia,2,0,0,0,2,1,9305
2005-06,Russia U18,WJC-18,6,2,2,4,6,1,9305
2005-06,Russia U18,Hlinka Memorial,5,3,1,4,2,7,9305
2005-06,Brandon Wheat Kings,WHL,70,27,34,61,69,5,10434
2005-06,Ässät,Liiga,51,4,8,12,57,0,4218
2005-06,Suomi U20,Mestis,2,1,0,1,12,0,4218
2005-06,Finland U20,WJC-20,7,2,2,4,8,0,4218
2005-06,New Hampshire Jr. Monarchs,EJHL,2,0,0,0,0,,12267
2005-06,Univ. of Maine,NCAA,23,0,5,5,14,4,12267
2005-06,Huddinge IK J20,SuperElit,28,19,15,34,157,14,3778
2005-06,Huddinge IK,Division 1,23,17,2,19,10,13,3778
2005-06,U.S. National U18 Team,USDP,41,9,16,25,35,,9311
2005-06,U.S. National U18 Team,NAHL,14,0,5,5,6,,9311
2005-06,USA U18,WJC-18,6,2,9,11,0,6,9311
2005-06,Linköping HC J18,J18 Elit,1,5,0,5,2,,3442
2005-06,Linköping HC J20,SuperElit,32,17,23,40,44,,3442
2005-06,Linköping HC,SHL,4,0,0,0,0,0,3442
2005-06,Sweden U19 (all),International-Jr,3,2,0,2,0,,3442
2005-06,U.S. National U18 Team,USDP,40,2,7,9,31,,9313
2005-06,U.S. National U18 Team,NAHL,15,0,5,5,41,,9313
2005-06,USA U18,WJC-18,6,0,0,0,4,4,9313
2005-06,Calgary Hitmen,WHL,72,20,33,53,121,10,11050
2005-06,Neftyanik Leninogorsk,Russia2,8,1,1,2,14,1,9298
2005-06,Russia U18,WJC-18,6,0,2,2,8,6,9298
2005-06,Green Bay Gamblers,USHL,56,3,12,15,205,13,12268
2005-06,Frölunda HC J18,J18 Allsvenskan,1,1,0,1,2,,3636
2005-06,Frölunda HC J20,SuperElit,38,10,18,28,72,,3636
2005-06,Frölunda HC,SHL,2,0,0,0,0,0,3636
2005-06,Sweden U18,WJC-18,6,3,2,5,16,-3,3636
2005-06,Sweden U18 (all),International-Jr,22,8,5,13,30,,3636
2005-06,Frölunda HC,ECC,2,0,0,0,0,0,3636
2005-06,Moncton Wildcats,QMJHL,68,29,37,66,83,40,10439
2005-06,Moncton Wildcats,M-Cup,5,2,2,4,2,1,10439
2005-06,Canada U18,JWC-18,5,2,2,4,16,,10439
2005-06,Oshawa Generals,OHL,66,35,33,68,139,-17,9359
2005-06,Everett Silvertips,WHL,66,8,25,33,52,7,11658
2005-06,Owen Sound Attack,OHL,67,6,9,15,236,-11,11266
2005-06,Södertälje SK J18,J18 Allsvenskan,7,9,5,14,2,,3696
2005-06,Södertälje SK J20,SuperElit,37,14,19,33,69,,3696
2005-06,Södertälje SK,SHL,1,0,0,0,0,0,3696
2005-06,Sweden U18,WJC-18,6,3,3,6,10,-1,3696
2005-06,Sweden U18 (all),International-Jr,20,8,6,14,18,,3696
2005-06,Sweden U20 (all),International-Jr,3,0,0,0,6,,3696
2005-06,CSKA Moskva-2,Russia3,48,17,22,39,74,,9303
2005-06,CSKA Moskva,Russia,4,0,1,1,4,2,9303
2005-06,Russia U18,WJC-18,6,1,2,3,6,1,9303
2005-06,Russia U18,Hlinka Memorial,5,2,1,3,6,3,9303
2005-06,Salisbury School,USHS-Prep,28,3,20,23,6,,15081
2005-06,Bowling Green State Univ.,NCAA,36,20,28,48,43,-12,11409
2005-06,Thief River Falls High,USHS-MN,21,23,37,60,28,,14868
2005-06,Des Moines Buccaneers,USHL,3,0,0,0,0,3,14868
2005-06,U.S. National U18 Team,USDP,4,1,0,1,0,,14868
2005-06,U.S. National U18 Team,USDP,60,21,33,54,102,,9321
2005-06,U.S. National U18 Team,NAHL,17,6,10,16,24,,9321
2005-06,USA U18,WJC-18,6,4,4,8,10,7,9321
2005-06,IF Björklöven J20,SuperElit,40,3,10,13,78,,3856
2005-06,IF Björklöven,Allsvenskan,6,0,0,0,4,0,3856
2005-06,Sweden U19 (all),International-Jr,5,1,1,2,18,,3856
2005-06,Brampton Battalion,OHL,68,0,10,10,103,10,10676
2005-06,Canada U18,Hlinka Memorial,5,0,3,3,6,10,10676
2005-06,Halifax Mooseheads,QMJHL,68,19,38,57,76,11,12270
2005-06,Plymouth Whalers,OHL,57,10,10,20,176,-1,12269
2005-06,Seattle Thunderbirds,WHL,72,21,13,34,18,8,11620
2005-06,Plymouth Whalers,OHL,65,14,23,37,75,-18,12271
2005-06,Frölunda HC J20,SuperElit,29,4,11,15,84,,3790
2005-06,Frölunda HC,SHL,15,0,0,0,2,1,3790
2005-06,Sweden U19 (all),International-Jr,4,0,0,0,6,,3790
2005-06,Warroad High,USHS-MN,23,9,21,30,-,,14866
2005-06,Brampton Battalion,OHL,68,30,38,68,107,11,11250
2005-06,HK Riga 2000,Belarus,41,4,11,15,16,,11335
2005-06,Latvia U18,WJC-18 D1,5,5,4,9,20,6,11335
2005-06,Latvia U20,WJC-20,6,0,2,2,4,-10,11335
2005-06,Latvia,WC,3,0,1,1,2,0,11335
2005-06,Latvia (all),International,8,1,1,2,2,,11335
2005-06,HK Riga 2000,Continental Cup,3,0,0,0,8,-1,11335
2005-06,Sarnia Sting,OHL,68,26,24,50,50,-31,11114
2005-06,Omaha Lancers,USHL,52,17,11,28,71,2,12272
2005-06,Kingston Frontenacs,OHL,67,10,29,39,134,14,9340
2005-06,Canada U18,WJC-18,7,0,2,2,4,6,9340
2005-06,Canada U18,JWC-18,5,0,0,0,2,,9340
2005-06,Mississauga IceDogs,OHL,68,17,26,43,86,-19,8396
2005-06,Oshawa Generals,OHL,67,6,26,32,136,-22,11233
2005-06,U.S. National U18 Team,USDP,43,11,12,23,30,,9315
2005-06,U.S. National U18 Team,NAHL,16,13,13,26,35,,9315
2005-06,USA U18,WJC-18,6,5,1,6,4,2,9315
2005-06,Ilves U18,Jr. B SM-sarja,2,0,1,1,0,,7452
2005-06,Ilves U20,Jr. A SM-liiga,39,9,16,25,22,10,7452
2005-06,Ilves,Liiga,1,0,0,0,0,0,7452
2005-06,Finland U18,WJC-18,6,1,2,3,12,2,7452
2005-06,Finland U18 (all),International-Jr,21,1,6,7,22,,7452
2005-06,Apple Valley High,USHS-MN,28,13,22,35,44,,12273
2005-06,Sioux City Musketeers,USHL,3,0,0,0,0,-2,12273
2005-06,Guelph Storm,OHL,66,1,15,16,85,21,11235
2005-06,HC Vsetin U20,Czech U20,1,1,1,2,0,-3,9286
2005-06,HC Vsetin,Czech,45,6,4,10,18,-28,9286
2005-06,HC Vsetin,Czech Q,-,-,-,-,-,,9286
2005-06,HC Sareza Ostrava,Czech2,7,2,1,3,2,0,9286
2005-06,HC Novy Jicin,Czech3,0,0,0,0,0,,9286
2005-06,Czech Republic U18,WJC-18,7,2,5,7,2,2,9286
2005-06,Czech Republic U18 (all),International-Jr,22,4,11,15,4,,9286
2005-06,Ilves U18,Jr. B SM-sarja,6,3,8,11,28,,8397
2005-06,Ilves U20,Jr. A SM-liiga,23,4,4,8,74,-5,8397
2005-06,Finland U18 (all),International-Jr,3,0,0,0,24,,8397
2005-06,Penticton Vees,BCHL,60,16,32,48,73,,12274
2005-06,U.S. National U18 Team,USDP,42,2,10,12,61,,9318
2005-06,U.S. National U18 Team,NAHL,17,4,6,10,15,,9318
2005-06,USA U18,WJC-18,6,0,0,0,0,5,9318
2005-06,EC Bad Tölz U18,DNL,2,1,1,2,6,,12276
2005-06,Tölzer Löwen,Germany2,36,2,3,5,80,,12276
2005-06,Germany U18,WJC-18,6,1,2,3,18,-4,12276
2005-06,Belleville Bulls,OHL,61,20,20,40,119,0,9338
2005-06,Canada U18,WJC-18,7,0,1,1,37,1,9338
2005-06,Lethbridge Hurricanes,WHL,55,5,13,18,79,-2,11673
2005-06,Leksands IF J18,J18 Allsvenskan,3,0,3,3,8,,3724
2005-06,Leksands IF J20,SuperElit,36,5,6,11,214,,3724
2005-06,Leksands IF,SHL,8,0,0,0,8,-1,3724
2005-06,Sweden U18,WJC-18,6,1,1,2,14,-2,3724
2005-06,Sweden U18 (all),International-Jr,20,1,3,4,30,,3724
2005-06,Sweden U19 (all),International-Jr,4,0,0,0,16,,3724
2005-06,Sweden U20 (all),International-Jr,3,0,0,0,4,,3724
2005-06,HC Kosice U20,Slovakia U20,35,26,21,47,50,39,9292
2005-06,HC Kosice,Slovakia,18,2,0,2,2,4,9292
2005-06,HKm Humenne,Slovakia2,5,2,2,4,4,3,9292
2005-06,Slovakia U18,WJC-18,6,1,2,3,6,2,9292
2005-06,Saint John Sea Dogs,QMJHL,65,21,31,52,61,-14,10613
2005-06,Germany U20,WJC-20 D1,5,1,3,4,8,2,10613
2005-06,Germany,WC D1,5,2,5,7,2,5,10613
2005-06,Germany (all),International,11,2,5,7,4,,10613
2005-06,Rouyn-Noranda Huskies,QMJHL,70,31,39,70,64,15,9343
2005-06,Canada U18,WJC-18,7,0,0,0,4,1,9343
2005-06,U.S. National U18 Team,USDP,2,0,1,1,2,,15065
2005-06,Gatineau Olympiques,QMJHL,55,7,25,32,38,7,12119
2005-06,Brampton Battalion,OHL,65,34,28,62,61,10,12277
2005-06,Kingston Frontenacs,OHL,56,35,40,75,47,9,11106
2005-06,Des Moines Buccaneers,USHL,59,10,12,22,80,5,12278
2005-06,Québec Remparts,QMJHL,70,25,22,47,79,29,10657
2005-06,Québec Remparts,M-Cup,4,2,3,5,2,2,10657
2005-06,Halifax Mooseheads,QMJHL,68,6,17,23,136,11,12279
2005-06,HIFK U18,Jr. B SM-sarja,2,2,3,5,4,,8393
2005-06,HIFK U20,Jr. A SM-liiga,39,11,9,20,24,1,8393
2005-06,Finland U18,WJC-18,5,2,1,3,2,1,8393
2005-06,Finland U18 (all),International-Jr,22,10,5,15,28,,8393
2005-06,HC Kladno U20,Czech U20,24,14,9,23,62,4,9282
2005-06,HC Kladno,Czech,20,0,0,0,0,-3,9282
2005-06,HC Plzen U20,Czech U20,6,2,1,3,2,-2,9282
2005-06,HC Plzen,Czech,5,0,0,0,4,-1,9282
2005-06,Czech Republic U18,WJC-18,7,1,2,3,37,-2,9282
2005-06,Czech Republic U18 (all),International-Jr,14,4,4,8,37,,9282
2005-06,Czech Republic U20 (all),International-Jr,3,0,0,0,2,0,9282
2005-06,Yale Univ.,NCAA,31,7,3,10,28,-12,12281
2005-06,Michigan State Univ.,NCAA,36,2,5,7,18,-2,11413
2005-06,HK Dukla Trencin U20,Slovakia U20,42,39,22,61,18,,10610
2005-06,HK Dukla Trencin,Slovakia,4,0,0,0,2,-1,10610
2005-06,HK 95 Povazska Bystrica,Slovakia2,5,0,1,1,2,,10610
2005-06,Newmarket Hurricanes,OPJHL,46,42,50,92,143,,12282
2005-06,Neftekhimik Nizhnekamsk,Russia,2,0,0,0,2,0,10496
2005-06,Neftekhimik Nizhnekamsk-2,Russia3,58,11,20,31,195,,10496
2005-06,Russian Selects,CHL Challenge,6,0,2,2,18,-2,10496
2005-06,Providence College,NCAA,36,6,15,21,24,4,12283
2005-06,Malmö Redhawks J18,J18 Allsvenskan,6,1,2,3,27,,3703
2005-06,Malmö Redhawks J20,SuperElit,39,5,10,15,28,,3703
2005-06,Sweden U18,WJC-18,6,0,1,1,2,-3,3703
2005-06,Sweden U18 (all),International-Jr,20,0,2,2,16,,3703
2005-06,Drummondville Voltigeurs,QMJHL,13,0,0,0,24,-2,19377
2005-06,Red Deer Rebels,WHL,14,11,6,17,27,-3,10637
2005-06,Kamloops Blazers,WHL,51,19,28,47,103,8,10637
2005-06,Collège Champlain Cougars,QJAAAHL,19,5,7,12,26,20,19376
2005-06,Providence College,NCAA,35,16,14,30,29,1,14861
2005-06,Salisbury School,USHS-Prep,28,10,17,27,51,,11427
2005-06,Rouyn-Noranda Huskies,QMJHL,69,14,27,41,97,10,11350
2005-06,KalPa U18,Jr. B SM-sarja,7,8,7,15,18,,8395
2005-06,KalPa U20,Jr. A SM-liiga,29,9,5,14,46,-2,8395
2005-06,Finland U18,WJC-18,6,1,2,3,10,0,8395
2005-06,Finland U18 (all),International-Jr,20,6,2,8,34,,8395
2005-06,HIFK U18,Jr. B SM-sarja,7,5,4,9,6,,8394
2005-06,HIFK U20,Jr. A SM-liiga,24,3,10,13,39,6,8394
2005-06,Finland U18,WJC-18,5,2,1,3,6,2,8394
2005-06,Finland U18 (all),International-Jr,16,4,5,9,18,,8394
2005-06,Medicine Hat Tigers,WHL,65,2,10,12,92,19,11669
2005-06,Lewiston MAINEiacs,QMJHL,69,19,29,48,44,10,9335
2005-06,Canada U18,WJC-18,7,0,1,1,2,2,9335
2005-06,Canada U18,JWC-18,5,0,0,0,0,,9335
2005-06,Peterborough Petes,OHL,16,4,15,19,10,8,8418
2005-06,Windsor Spitfires,OHL,49,12,21,33,21,8,8418
2005-06,Jokerit U18,Jr. B SM-sarja Q,4,1,6,7,2,,8392
2005-06,Jokerit U18,Jr. B SM-sarja,12,7,7,14,26,,8392
2005-06,Jokerit U20,Jr. A SM-liiga,36,3,12,15,35,0,8392
2005-06,Suomi U20,Mestis,1,0,0,0,0,-1,8392
2005-06,Finland U18,WJC-18,6,3,2,5,0,0,8392
2005-06,Finland U18 (all),International-Jr,20,9,8,17,6,,8392
2005-06,Lakeland High,USHS-WI,21,41,23,64,43,,14387
2005-06,Swift Current Broncos,WHL,63,21,17,38,63,-17,9349
2005-06,Canada U18,WJC-18,7,0,0,0,10,1,9349
2005-06,Lethbridge Hurricanes,WHL,18,0,7,7,12,4,11640
2005-06,Prince George Cougars,WHL,6,0,4,4,15,-2,11640
2005-06,Moncton Wildcats,QMJHL,68,6,40,46,62,22,12406
2005-06,Moncton Wildcats,M-Cup,5,0,1,1,2,-2,12406
2005-06,Frölunda HC J20,SuperElit,41,27,26,53,89,26,4202
2005-06,Sweden U20 (all),International-Jr,3,1,0,1,4,,4202
2005-06,EHC Basel,NLA,37,2,0,2,39,,12653
2005-06,EHC Olten,NLB,2,0,0,0,2,,12653
2005-06,Switzerland U20,WJC-20,6,2,2,4,6,-1,12653
2005-06,CSKA Moskva,Russia,39,7,7,14,26,2,9264
2005-06,Russia U20,WJC-20,6,3,2,5,8,4,9264
2005-06,Eisbären Juniors Berlin U18,DNL,7,8,4,12,14,,9273
2005-06,Eisbären Berlin,DEL,6,0,0,0,0,0,9273
2005-06,Eisbären Juniors Berlin,Germany3,14,5,5,10,18,,9273
2005-06,Germany U18,WJC-18,6,2,4,6,4,-3,9273
2005-06,HIFK U20,Jr. A SM-liiga,37,24,18,42,14,23,8067
2005-06,Suomi U20,Mestis,4,1,1,2,0,0,8067
2005-06,Shattuck St. Mary's Midget Prep,USHS-Prep,60,38,51,89,70,,11444
2005-06,Kloten U20,Elite Jr. A,42,21,42,63,196,,10616
2005-06,Kloten Flyers,NLA,8,0,1,1,4,,10616
2005-06,EHC Biel-Bienne,NLB,3,0,0,0,2,,10616
2005-06,Switzerland U20,WJC-20,6,1,3,4,6,-1,10616
2005-06,Saskatoon Blades,WHL,42,0,9,9,85,-1,11696
2005-06,Swift Current Broncos,WHL,29,1,11,12,64,-14,11696
2005-06,Wellington Dukes,OPJHL,47,41,51,92,46,,15843
2005-06,Canada Jr A Selects,Junior Grand Prix,4,1,1,2,6,,15843
2005-06,Lada Togliatti,Russia,40,9,12,21,28,-1,9592
2005-06,Lada Togliatti,Continental Cup,3,1,1,2,0,1,9592
2005-06,The Governor's Academy,USHS-Prep,28,9,13,22,34,,15309
2005-06,HPK U20,Jr. A SM-liiga,3,4,2,6,4,4,4222
2005-06,HPK,Liiga,50,8,3,11,24,9,4222
2005-06,Suomi U20,Mestis,2,2,0,2,2,-1,4222
2005-06,Finland U20,WJC-20,7,0,1,1,2,1,4222
2005-06,Prince George Cougars,WHL,71,40,32,72,125,11,9492
2005-06,U.S. National U18 Team,USDP,42,10,12,22,57,,9316
2005-06,U.S. National U18 Team,NAHL,17,6,5,11,20,,9316
2005-06,USA U18,WJC-18,6,2,1,3,4,2,9316
2005-06,Acadie-Bathurst Titan,QMJHL,62,18,34,52,42,20,10441
2005-06,New York Bobcats,AtJHL,40,50,52,102,38,,12468
2005-06,Breck School,USHS-MN,28,45,36,81,76,,15452
2005-06,Ässät U20,Jr. A SM-liiga,10,5,6,11,59,4,7617
2005-06,Ässät,Liiga,44,3,3,6,106,2,7617
2005-06,Suomi U20,Mestis,5,0,3,3,4,2,7617
2005-06,Finland U20,WJC-20,7,0,3,3,32,-1,7617
2005-06,Beaver Valley NiteHawks,KIJHL,38,14,25,39,64,,12264
2005-06,Vernon Vipers,BCHL,8,1,0,1,9,,12264
2005-06,HC Ceské Budejovice U20,Czech U20,43,15,15,30,32,15,11112
2005-06,Slovenia U18,WJC-18 D1,5,1,1,2,8,1,11112
2005-06,Slovenia U20,WJC-20 D1,5,3,2,5,2,2,11112
2005-06,Clarkson Univ.,NCAA,38,16,25,41,72,11,11439
2005-06,IF Björklöven J20,SuperElit,11,1,3,4,20,,3679
2005-06,IF Björklöven,Allsvenskan,31,1,0,1,45,3,3679
2005-06,Sweden U19 (all),International-Jr,9,0,1,1,14,,3679
2005-06,Sweden U20 (all),International-Jr,3,0,0,0,2,,3679
2005-06,HIFK U20,Jr. A SM-liiga,30,7,11,18,65,9,7410
2005-06,HIFK,Liiga,21,0,0,0,2,0,7410
2005-06,Suomi U20,Mestis,6,2,2,4,10,5,7410
2005-06,Finland U20,WJC-20,7,2,2,4,4,4,7410
2005-06,Hamilton Red Wings,OPJHL,21,10,12,22,25,,12260
2005-06,Sudbury Wolves,OHL,60,15,21,36,202,0,11320
2005-06,Western Michigan Univ.,NCAA,38,2,2,4,127,-19,12261
2005-06,Medicine Hat Tigers,WHL,68,25,23,48,279,14,11666
2005-06,Springfield Jr. Blues,NAHL,54,14,22,36,13,,12263
2005-06,Cretin-Derham Hall,USHS-MN,-,-,-,-,-,,14398
2005-06,Moncton Wildcats,QMJHL,68,16,9,25,69,-4,12259
2005-06,Moncton Wildcats,M-Cup,5,1,0,1,2,-1,12259
2005-06,Spruce Grove Saints,AJHL,40,15,29,44,122,,12183
2005-06,Boston College,NCAA,42,16,9,25,36,9,9378
2005-06,Prince George Cougars,WHL,56,2,5,7,87,-6,11642
2005-06,HK MVD,Russia,26,0,0,0,12,1,12232
2005-06,HK MVD-THK Tver,Russia3,31,4,13,17,34,,12232
2005-06,Portland Winter Hawks,WHL,21,2,8,10,71,5,11655
2005-06,CSKA Moskva-2,Russia3,40,3,9,12,24,,11357
2005-06,Latvia U18,WJC-18 D1,5,1,2,3,12,10,11357
2005-06,Latvia U20,WJC-20,6,0,1,1,6,0,11357
2005-06,Latvia (all),International,3,0,0,0,0,,11357
2005-06,Boston Univ.,NCAA,32,2,2,4,12,-1,12262
2005-06,Academy of Holy Angels,USHS-MN,20,28,38,66,-,,10909
2005-06,Sioux Falls Stampede,USHL,13,5,7,12,2,8,10909
2005-06,HC Trinec U20,Czech U20,29,8,3,11,81,0,11648
2005-06,HC Trinec,Czech,1,0,0,0,0,0,11648
2005-06,Slovakia U18,WJC-18,6,1,1,2,10,-3,11648
2005-06,Traktor Chelyabinsk,Russia2,37,8,8,16,26,7,9299
2005-06,Traktor Chelyabinsk-2,Russia3,2,1,4,5,0,,9299
2005-06,Russia U18,WJC-18,6,3,2,5,8,6,9299
2005-06,Russia U18,Hlinka Memorial,5,1,3,4,0,3,9299
2005-06,VIK Hockey Ungdom J20,SuperElit,31,12,5,17,79,1,4575
2005-06,Sweden U18,WJC-18,6,1,2,3,2,-2,4575
2005-06,Sweden U18 (all),International-Jr,15,3,2,5,14,,4575
2005-06,Baie-Comeau Drakkar,QMJHL,68,30,38,68,60,-20,12160
2005-06,Shawinigan Cataractes,QMJHL,68,3,4,7,200,11,12258
2005-06,Färjestad BK J18,J18 Allsvenskan,14,3,1,4,38,,3900
2005-06,Univ. of Notre Dame,NCAA,36,6,28,34,32,-2,11419
2005-06,Regina Pats,WHL,71,10,35,45,89,-14,9344
2005-06,Canada U18,WJC-18,7,1,3,4,10,-2,9344
2005-06,Canada U18,JWC-18,5,2,0,2,4,,9344
2005-06,Penticton Vees,BCHL,55,7,15,22,25,,12256
2005-06,Germany U20,WJC-20 D1,5,0,1,1,2,3,12256
2005-06,Germany U20 (all),International-Jr,11,0,2,2,6,,12256
2006-07,London Knights,OHL,58,62,83,145,52,42,9326
2006-07,USA U20,WJC-20,7,5,4,9,4,2,9326
2006-07,U.S. National U18 Team,NAHL,12,13,12,25,37,,9324
2006-07,U.S. National U18 Team,USDP,30,20,18,38,44,,9324
2006-07,USA U18,WJC-18,7,5,7,12,4,2,9324
2006-07,USA U20,WJC-20,7,1,0,1,2,1,9324
2006-07,Coquitlam Express,BCHL,53,66,55,121,83,,11345
2006-07,Canada U18,WJC-18,6,3,2,5,2,2,11345
2006-07,Canada West U19,WJAC-19,4,5,6,11,4,,11345
2006-07,Canada U18,Hlinka Memorial,4,1,1,2,2,,11345
2006-07,Seattle Thunderbirds,WHL,68,9,41,50,70,15,11617
2006-07,Canada U18,Hlinka Memorial,4,0,1,1,2,,11617
2006-07,Calgary Hitmen,WHL,63,8,39,47,32,16,10429
2006-07,Canada U20,WJC-20,6,0,1,1,2,1,10429
2006-07,London Knights,OHL,53,35,83,118,36,32,10425
2006-07,Canada U20,WJC-20,6,0,0,0,8,0,10425
2006-07,Halifax Mooseheads,QMJHL,59,23,63,86,26,-7,9285
2006-07,Czech Republic U18,WJC-18,4,1,2,3,2,0,9285
2006-07,Czech Republic U18 (all),International-Jr,8,5,5,10,4,,9285
2006-07,Czech Republic U20,WJC-20,6,1,2,3,4,-4,9285
2006-07,Czech Republic U20 (all),International-Jr,7,1,3,4,4,,9285
2006-07,Everett Silvertips,WHL,69,32,61,93,90,16,11053
2006-07,Ottawa 67's,OHL,54,26,52,78,24,-1,11109
2006-07,Canada U18,WJC-18,6,2,2,4,2,3,11109
2006-07,Kamloops Blazers,WHL,69,2,23,25,120,-2,9333
2006-07,Red Deer Rebels,WHL,71,20,37,57,54,-3,9339
2006-07,Canada U18,WJC-18,6,1,1,2,2,0,9339
2006-07,Canada U18,Hilinka Memorial,4,0,2,2,0,,9339
2006-07,Cretin-Derham Hall,USHS-MN,23,10,23,33,44,,11458
2006-07,USA U18,WJC-18,7,0,3,3,4,-1,11458
2006-07,Frölunda HC J18,J18 Allsvenskan,2,1,3,4,6,3,5995
2006-07,Frölunda HC J20,SuperElit,39,18,37,55,58,22,5995
2006-07,Denmark U18,WJC-18 D1,5,3,7,10,6,5,5995
2006-07,Denmark U20,WJC-20 D1,5,2,5,7,16,6,5995
2006-07,U.S. National U18 Team,USDP,43,8,19,27,36,,11460
2006-07,U.S. National U18 Team,NAHL,14,5,8,13,26,,11460
2006-07,USA U18,WJC-18,7,1,4,5,2,-1,11460
2006-07,Calgary Hitmen,WHL,58,8,30,38,81,18,11706
2006-07,Saskatoon Blades,WHL,65,13,17,30,148,-20,11100
2006-07,Canada U18,WJC-18,6,2,1,3,10,3,11100
2006-07,Avangard Omsk,Russia,46,18,11,29,45,14,10626
2006-07,Avangard Omsk-2,Russia3,3,1,0,1,0,,10626
2006-07,Russia U18,WJC-18,7,5,3,8,6,1,10626
2006-07,Russia U20,WJC-20,6,5,3,8,2,2,10626
2006-07,Russia U18 (all),International-Jr,15,8,6,14,12,5,10626
2006-07,Russia U20 (all),International-Jr,6,5,3,8,2,2,10626
2006-07,Russia U18,Hlinka Memorial,4,1,1,2,4,1,10626
2006-07,U.S. National U18 Team,USDP,42,6,11,17,36,,11456
2006-07,U.S. National U18 Team,NAHL,16,2,7,9,28,,11456
2006-07,USA U18,WJC-18,7,4,1,5,6,4,11456
2006-07,Halifax Mooseheads,QMJHL,68,20,35,55,82,-5,12504
2006-07,Québec Remparts,QMJHL,60,27,52,79,63,9,10436
2006-07,Canada U18,WJC-18,6,3,3,6,0,3,10436
2006-07,Salmon Arm Silverbacks,BCHL,55,38,46,84,87,,12507
2006-07,Canada West U19,WJAC-19,4,1,4,5,2,,12507
2006-07,Sioux City Musketeers,USHL,60,21,42,63,119,20,12461
2006-07,Vancouver Giants,WHL,72,8,43,51,48,37,11597
2006-07,Vancouver Giants,M-Cup,5,0,1,1,0,3,11597
2006-07,USA U18,Hlinka Memorial,4,1,2,3,0,,11597
2006-07,VIK Västerås HK J18,J18 Allsvenskan,2,2,1,3,2,,4295
2006-07,VIK Västerås HK J20,SuperElit,7,5,4,9,8,,4295
2006-07,VIK Västerås HK,Allsvenskan,18,1,2,3,14,1,4295
2006-07,Sweden U18,WJC-18,6,6,1,7,6,0,4295
2006-07,Sweden U18 (all),International-Jr,16,7,3,10,14,,4295
2006-07,Grand Rapids High,USHS-MN,17,11,25,36,16,,11470
2006-07,Tri-City Storm,USHL,12,8,1,9,4,5,11470
2006-07,USA U18,WJC-18,7,3,2,5,6,5,11470
2006-07,USA U18,Hlinka Memorial,4,1,0,1,2,,11470
2006-07,Lewiston MAINEiacs,QMJHL,70,39,44,83,75,37,11123
2006-07,Lewiston MAINEiacs,M-Cup,4,1,2,3,0,-1,11123
2006-07,St. Michael's Buzzers,OPJHL,39,12,24,36,90,,12506
2006-07,Canada East U19,WJAC-19,4,0,2,2,2,,12506
2006-07,Omaha Lancers,USHL,54,11,14,25,177,16,12207
2006-07,Univ. of Minnesota,NCAA,43,7,8,15,51,4,9319
2006-07,USA U18,WJC-18,7,3,4,7,12,0,9319
2006-07,Regina Pats,WHL,70,7,24,31,87,11,11099
2006-07,Canada U18,Hlinka Memorial,4,1,0,1,0,,11099
2006-07,St. John's Fog Devils,QMJHL,68,16,25,41,79,-8,12169
2006-07,Oshawa Generals,OHL,68,47,53,100,43,9,11108
2006-07,Everett Silvertips,WHL,60,5,8,13,65,5,11695
2006-07,Sault Ste. Marie Greyhounds,OHL,68,24,33,57,80,-2,12512
2006-07,Westminster Prep.,USHS-Prep,25,8,12,20,20,,11457
2006-07,U.S. National U18 Team,NAHL,2,0,2,2,0,,11457
2006-07,USA U18,WJC-18,7,0,1,1,4,2,11457
2006-07,Mississauga IceDogs,OHL,64,43,32,75,115,31,12460
2006-07,Colorado College,NCAA,30,9,17,26,18,1,9322
2006-07,USA U20,WJC-20,7,1,1,2,0,-1,9322
2006-07,Frölunda HC J18,J18 Allsvenskan,2,2,2,4,2,,5009
2006-07,Frölunda HC J20,SuperElit,41,31,23,54,91,,5009
2006-07,Gislaveds SK,Division 1,2,0,1,1,0,0,5009
2006-07,Sweden U18,WJC-18,6,4,5,9,4,8,5009
2006-07,Sweden U18 (all),International-Jr,22,7,13,20,14,,5009
2006-07,Vancouver Giants,WHL,56,24,31,55,56,20,10481
2006-07,Czech Republic U20,WJC-20,6,0,0,0,0,-2,10481
2006-07,Czech Republic U20 (all),International-Jr,11,1,2,3,4,,10481
2006-07,Vancouver Giants,M-Cup,5,3,4,7,4,7,10481
2006-07,Lewiston MAINEiacs,QMJHL,70,5,27,32,141,34,12508
2006-07,Lewiston MAINEiacs,M-Cup,4,0,0,0,2,-4,12508
2006-07,Belleville Bulls,OHL,65,5,15,20,32,12,12514
2006-07,Belleville Bulls,OHL,68,15,41,56,89,12,11251
2006-07,Des Moines Buccaneers,USHL,56,22,45,67,62,5,12513
2006-07,Lincoln Stars,USHL,53,13,47,60,110,5,12463
2006-07,U.S. National U18 Team,NAHL,4,1,3,4,0,,12463
2006-07,U.S. National U18 Team,NAHL,9,3,6,9,14,,11459
2006-07,U.S. National U18 Team,USDP,39,5,11,16,64,,11459
2006-07,USA U18,WJC-18,7,0,1,1,0,7,11459
2006-07,Prince George Cougars,WHL,72,30,26,56,51,4,11638
2006-07,Virginia/Mountain Iron-Buhl High,USHS-MN,25,38,52,90,22,,12509
2006-07,Victoriaville Tigres,QMJHL,70,20,35,55,53,-6,11402
2006-07,Canada U18,WJC-18,2,0,1,1,0,0,11402
2006-07,Chilliwack Bruins,WHL,68,32,37,69,50,1,5504
2006-07,Sweden U18,WJC-18,6,1,4,5,20,0,5504
2006-07,Sweden U18 (all),International-Jr,12,5,5,10,24,,5504
2006-07,Gaylord High,USHS-MI,25,18,20,38,104,,12515
2006-07,Dartmouth College,NCAA,33,14,17,31,30,15,12464
2006-07,Sudbury Wolves,OHL,53,20,22,42,104,0,11116
2006-07,U.S. National U18 Team,USDP,44,16,7,23,28,,12457
2006-07,U.S. National U18 Team,NAHL,11,6,5,11,10,,12457
2006-07,Kitchener Rangers,OHL,61,23,36,59,41,24,12462
2006-07,Mississauga IceDogs,OHL,66,6,15,21,40,13,12516
2006-07,Québec Remparts,QMJHL,64,30,37,67,117,11,9301
2006-07,Russian Selects,CHL Challenge,2,0,0,0,2,0,9301
2006-07,Owen Sound Attack,OHL,66,23,26,49,112,-10,12517
2006-07,Sarnia Sting,OHL,68,5,35,40,31,8,11395
2006-07,Canada U18,WJC-18,6,0,1,1,0,10,11395
2006-07,Canada U18,Hlinka Memorial,4,0,2,2,0,,11395
2006-07,Rouyn-Noranda Huskies,QMJHL,14,1,3,4,10,-2,12518
2006-07,Dynamo Moskva,Russia,7,0,0,0,8,1,11864
2006-07,Dynamo Moskva-2,Russia3,39,33,33,66,44,,11864
2006-07,Russia U18,WJC-18,7,5,1,6,4,1,11864
2006-07,Russia U18,Hlinka Memorial,4,2,2,4,6,1,11864
2006-07,Russia U19,WJAC-19,5,2,4,6,0,,11864
2006-07,Rimouski Océanic,QMJHL,69,28,36,64,28,-8,11391
2006-07,Canada U18,WJC-18,6,0,1,1,0,-1,11391
2006-07,Saskatoon Blades,WHL,63,2,2,4,107,-6,12519
2006-07,Vancouver Giants,WHL,63,21,24,45,32,26,12505
2006-07,Vancouver Giants,M-Cup,5,3,0,3,0,1,12505
2006-07,White Bear Lake High,USHS-MN,25,28,43,71,-,,12520
2006-07,Sioux Falls Stampede,USHL,15,4,4,8,14,-1,12520
2006-07,Rimouski Océanic,QMJHL,54,24,36,60,32,-14,11129
2006-07,Kootenay Ice,WHL,44,1,15,16,57,11,11398
2006-07,Canada U18,WJC-18,6,0,1,1,2,-4,11398
2006-07,Traktor Chelyabinsk,Russia,24,1,1,2,8,-6,11859
2006-07,Traktor Chelyabinsk-2,Russia3,4,2,0,2,14,,11859
2006-07,Russia U18,WJC-18,7,2,2,4,2,1,11859
2006-07,Russia U18,Hlinka Memorial,4,4,2,6,0,5,11859
2006-07,Russia U19,WJAC-19,5,3,2,5,4,,11859
2006-07,Spokane Chiefs,WHL,61,24,19,43,55,1,12521
2006-07,Bern U20,Elite Jr. A,1,0,0,0,2,,10615
2006-07,Kitchener Rangers,OHL,51,13,28,41,42,5,10615
2006-07,Switzerland U20,WJC-20,6,1,3,4,10,0,10615
2006-07,Switzerland U20 (all),International-Jr,12,1,3,4,10,,10615
2006-07,Oshawa Generals,OHL,67,43,37,80,81,3,12113
2006-07,GCK Lions U20,Elite Jr. A,13,9,7,16,22,,10902
2006-07,GC Küsnacht Lions,NLB,5,1,1,2,0,,10902
2006-07,HC Thurgau,NLB,5,1,0,1,6,,10902
2006-07,SC Weinfelden,SwissDiv1,1,2,0,2,0,,10902
2006-07,EHC Dübendorf,SwissDiv1,11,8,8,16,18,18,10902
2006-07,Schweiz U-20,NLB,3,0,0,0,2,,10902
2006-07,Switzerland U18,WJC-18,6,3,1,4,6,-5,10902
2006-07,Switzerland U18 (all),International-Jr,24,6,6,12,6,,10902
2006-07,Lincoln Stars,USHL,32,16,20,36,10,28,12522
2006-07,Deerfield Academy,USHS-Prep,25,18,14,32,-,,12523
2006-07,Kitchener Rangers,OHL,63,2,12,14,67,15,12524
2006-07,Erie Otters,OHL,56,24,21,45,99,-24,12525
2006-07,Merritt Centennials,BCHL,55,51,65,116,42,,11590
2006-07,Canada West U19,WJAC-19,4,3,6,9,4,,11590
2006-07,Univ. of Notre Dame,NCAA,42,20,21,41,22,22,11420
2006-07,Belleville Bulls,OHL,60,33,25,58,50,-6,11244
2006-07,Sioux City Musketeers,USHL,60,26,47,73,60,13,12526
2006-07,Calgary Hitmen,WHL,71,21,9,30,65,3,12527
2006-07,Canada U18,Hlinka Memorial,4,5,1,6,4,,12527
2006-07,Cowichan Valley Capitals,BCHL,44,4,10,14,63,,12528
2006-07,Frölunda HC J18,J18 Allsvenskan,2,1,2,3,2,,4087
2006-07,Frölunda HC J20,SuperElit,41,20,26,46,60,,4087
2006-07,Frölunda HC,SHL,1,0,0,0,0,0,4087
2006-07,Kungälvs IK,Division 1,2,0,0,0,2,0,4087
2006-07,Sweden U18,WJC-18,6,0,1,1,4,1,4087
2006-07,Sweden U18 (all),International-Jr,22,4,10,14,18,,4087
2006-07,Sioux Falls Stampede,USHL,54,26,36,62,76,-3,12187
2006-07,St. Michael's Buzzers,OPJHL,37,23,27,50,45,,12529
2006-07,Canada East U19,WJAC-19,4,1,3,4,0,,12529
2006-07,U.S. National U18 Team,USDP,34,4,5,9,47,,11468
2006-07,U.S. National U18 Team,NAHL,15,4,1,5,22,,11468
2006-07,USA U18,WJC-18,7,3,3,6,2,1,11468
2006-07,Univ. of Michigan,NCAA,35,1,3,4,24,3,12530
2006-07,Neftyanik Leninogorsk,Russia2,28,6,4,10,6,-5,12466
2006-07,Neftyanik Almetievsk,Russia2,6,1,1,2,0,-1,12466
2006-07,Ak Bars Kazan-2,Russia3,2,0,0,0,0,,12466
2006-07,Russia U19,WJAC-19,5,3,1,4,0,,12466
2006-07,Miami Univ. (Ohio),NCAA,42,9,15,24,40,-3,12531
2006-07,U.S. National U18 Team,USDP,36,3,16,19,34,,9309
2006-07,U.S. National U18 Team,NAHL,13,1,6,7,16,,9309
2006-07,USA U18,WJC-18,7,1,6,7,10,3,9309
2006-07,Luleå HF,SHL,50,8,9,17,32,-1,4008
2006-07,Sweden U20,WJC-20,7,2,3,5,4,4,4008
2006-07,Sweden U20 (all),International-Jr,16,2,4,6,10,,4008
2006-07,Fort Saskatchewan Traders,AJHL,58,49,34,83,75,,12534
2006-07,Stevens Point Area High,USHS-WI,20,22,-,-,-,,12535
2006-07,Lincoln Stars,USHL,8,0,0,0,4,-7,12535
2006-07,U.S. National U18 Team,USDP,33,3,11,14,46,,11464
2006-07,U.S. National U18 Team,NAHL,15,9,6,15,31,,11464
2006-07,USA U18,WJC-18,7,2,2,4,6,3,11464
2006-07,Saskatoon Blades,WHL,61,16,33,49,98,-3,12536
2006-07,HC Slavia Praha U20,Czech U20,37,24,34,58,54,15,9283
2006-07,HC Slavia Praha,Czech,3,0,0,0,0,-1,9283
2006-07,Czech Republic U18,WJC-18,6,2,4,6,4,2,9283
2006-07,Czech Republic U18 (all),International-Jr,14,4,13,17,8,,9283
2006-07,Salmon Arm Silverbacks,BCHL,39,27,30,57,58,,12537
2006-07,Canada West U19,WJAC-19,4,3,2,5,2,,12537
2006-07,Sioux Falls Stampede,USHL,57,14,19,33,134,6,12188
2006-07,Rimouski Océanic,QMJHL,70,35,42,77,88,-7,11128
2006-07,Lethbridge Hurricanes,WHL,71,36,48,84,54,9,11058
2006-07,Omaha Lancers,USHL,55,12,28,40,55,10,12538
2006-07,Lethbridge Hurricanes,WHL,62,12,32,44,39,8,12539
2006-07,Canada U18,Hilinka Memorial,4,0,0,0,0,,12539
2006-07,Spokane Chiefs,WHL,62,3,12,15,88,11,12543
2006-07,Mississauga IceDogs,OHL,68,27,38,65,66,22,11313
2006-07,Portland Winter Hawks,WHL,49,12,26,38,38,-17,12557
2006-07,Des Moines Buccaneers,USHL,59,22,42,64,66,-2,12558
2006-07,Tappara U18,Jr. B SM-sarja,7,5,3,8,32,,9271
2006-07,Tappara U20,Jr. A SM-liiga,33,14,14,28,44,1,9271
2006-07,Tappara,Liiga,5,0,0,0,0,0,9271
2006-07,Finland U18,WJC-18,4,1,1,2,4,-1,9271
2006-07,Finland U18 (all),International-Jr,11,5,7,12,12,,9271
2006-07,Brandon Wheat Kings,WHL,66,1,8,9,82,3,12561
2006-07,Kitchener Rangers,OHL,67,33,33,66,20,11,12560
2006-07,Saint John Sea Dogs,QMJHL,68,12,20,32,108,-32,11393
2006-07,Canada U18,WJC-18,6,0,0,0,0,0,11393
2006-07,Canada U18,Hlinka Memorial,4,0,0,0,0,,11393
2006-07,Chilliwack Bruins,WHL,72,29,53,82,46,-5,11052
2006-07,Shattuck St. Mary's Midget Prep,USHS-Prep,63,11,25,36,144,,14382
2006-07,St. John's Fog Devils,QMJHL,62,23,19,42,51,-19,4407
2006-07,CSKA Moskva,Russia,18,0,0,0,10,-3,11861
2006-07,CSKA Moskva-2,Russia3,22,2,3,5,34,,11861
2006-07,Russia U18,WJC-18,7,0,0,0,6,1,11861
2006-07,Russia U19,WJAC-19,4,0,0,0,0,,11861
2006-07,Regina Pats,WHL,69,13,13,26,114,5,13812
2006-07,U.S. National U18 Team,USDP,23,1,0,1,18,,12459
2006-07,U.S. National U18 Team,NAHL,18,1,8,9,22,,12459
2006-07,HC Topolcany U18,Slovakia U18,53,37,54,91,84,,11850
2006-07,HC Topolcany,Slovakia2,22,4,7,11,53,,11850
2006-07,Slovakia U18,WJC-18,6,2,5,7,10,2,11850
2006-07,Slovakia U19,WJAC-19,-,-,-,-,-,,11850
2006-07,The Gunnery Prep,USHS-Prep,-,-,-,-,-,,18748
2006-07,Victoria Grizzlies,BCHL,53,42,23,65,78,,15399
2006-07,Heilbronner Falken,Germany3,16,0,1,1,16,,11845
2006-07,Jungadler Mannheim U18,DNL,34,9,16,25,82,,11845
2006-07,Germany U18,WJC-18,6,1,3,4,4,-2,11845
2006-07,Germany U18 (all),International-Jr,14,1,3,4,10,,11845
2006-07,Moorhead High,USHS-MN,26,6,33,39,62,,14400
2006-07,Waterloo Black Hawks,USHL,27,2,7,9,56,0,14400
2006-07,Plymouth Whalers,OHL,68,22,44,66,98,18,14370
2006-07,Plymouth Whalers,M-Cup,5,0,0,0,8,0,14370
2006-07,Grand Rapids High,USHS-MN,-,14,20,34,-,,15058
2006-07,HK Dukla Trencin U20,Slovakia U20,42,9,15,24,72,,12533
2006-07,HK Dukla Trencin,Slovakia,22,0,0,0,2,-2,12533
2006-07,HK 95 Povazska Bystrica,Slovakia2,7,0,3,3,2,,12533
2006-07,Salisbury School,USHS-Prep,24,16,11,27,16,,14386
2006-07,Spokane Chiefs,WHL,70,4,44,48,42,1,11103
2006-07,Czech Republic U18,WJC-18,6,2,4,6,0,1,11103
2006-07,Czech Republic U18 (all),International-Jr,10,3,9,12,2,,11103
2006-07,Waterloo Black Hawks,USHL,60,25,29,54,66,18,17842
2006-07,Strathroy Rockets,WOHL,46,46,49,95,84,,15049
2006-07,Kelowna Rockets,WHL,68,15,28,43,72,-14,11683
2006-07,Sault Ste. Marie Greyhounds,OHL,37,1,3,4,10,-5,13614
2006-07,Soo Thunderbirds,NOJHL,4,0,3,3,2,,13614
2006-07,Omaha Lancers,USHL,56,25,25,50,105,17,14390
2006-07,Windsor Spitfires,OHL,68,22,32,54,76,-27,13837
2006-07,Malmö Redhawks,SHL,48,10,5,15,26,2,4024
2006-07,Sweden U20,WJC-20,7,1,2,3,4,2,4024
2006-07,Sweden U20 (all),International-Jr,16,5,6,11,12,,4024
2006-07,Baie-Comeau Drakkar,QMJHL,69,27,21,48,67,15,12162
2006-07,CSKA Moskva,Russia,24,0,0,0,0,-2,13965
2006-07,CSKA Moskva-2,Russia3,42,10,25,35,38,,13965
2006-07,St. John's Fog Devils,QMJHL,69,12,38,50,47,-30,12170
2006-07,Moncton Wildcats,QMJHL,70,17,22,39,44,-21,17843
2006-07,Belleville Bulls,OHL,52,4,4,8,25,-6,13667
2006-07,Nobles Prep,USHS-Prep,27,14,10,24,8,,18746
2006-07,Gatineau Olympiques,QMJHL,36,23,31,54,50,13,14607
2006-07,Prince Edward Island Rocket,QMJHL,28,12,24,36,26,-1,14607
2006-07,Minnesota State Univ. (Mankato),NCAA,37,17,10,27,74,5,17719
2006-07,Frölunda HC J18,J18 Elit,2,0,2,2,0,,5509
2006-07,Frölunda HC J18,J18 Allsvenskan,1,0,0,0,0,,5509
2006-07,Frölunda HC J20,SuperElit,40,4,6,10,26,,5509
2006-07,Sweden U18,WJC-18,6,0,0,0,6,0,5509
2006-07,Sweden U18 (all),International-Jr,22,0,5,5,12,,5509
2006-07,Windsor Spitfires,OHL,48,3,9,12,149,-7,13632
2006-07,Tingsryds AIF J18,J18 Elit,12,8,10,18,12,,6912
2006-07,Tingsryds AIF J18,J18 Allsvenskan,4,0,0,0,6,,6912
2006-07,Tingsryds AIF J20,J20 Elit,20,8,15,23,72,,6912
2006-07,Tingsryds AIF,Division 1,7,0,0,0,0,0,6912
2006-07,Sweden U18 (all),International-Jr,2,0,0,0,0,,6912
2006-07,Aurora Tigers,OPJHL,43,10,32,42,34,,12559
2006-07,Aurora Tigers,Dudley Hewitt Cup,4,0,3,3,6,,12559
2006-07,Canada East U19,WJAC-19,4,0,3,3,8,,12559
2006-07,Erie Otters,OHL,52,7,3,10,176,-33,15038
2006-07,St. Louis Bandits,NAHL,57,40,55,95,152,,12063
2006-07,Plymouth Whalers,OHL,50,0,12,12,50,48,14729
2006-07,Tecumseh Chiefs,WOHL,4,0,3,3,10,,14729
2006-07,Plymouth Whalers,M-Cup,5,0,1,1,4,0,14729
2006-07,HV71 J18,J18 Allsvenskan,1,0,0,0,2,,4509
2006-07,HV71 J20,SuperElit,17,3,1,4,42,,4509
2006-07,Sweden U18,WJC-18,6,0,1,1,6,5,4509
2006-07,Sweden U18 (all),International-Jr,11,0,1,1,16,,4509
2006-07,Saint John Sea Dogs,QMJHL,70,25,50,75,60,-14,11319
2006-07,Rögle BK,Allsvenskan,29,16,18,34,28,17,2020
2006-07,Sweden U20,WJC-20,7,1,1,2,12,1,2020
2006-07,Sweden U20 (all),International-Jr,16,5,2,7,20,,2020
2006-07,Waterloo Black Hawks,USHL,59,11,27,38,38,12,12176
2006-07,Luleå HF,SHL,55,12,10,22,30,8,2349
2006-07,Sweden (all),International,2,2,1,3,0,1,2349
2006-07,Södertälje SK J20,SuperElit,40,24,31,55,42,,4567
2006-07,Sweden U19 (all),International-Jr,8,1,3,4,2,,4567
2006-07,HC Vsetin U20,Czech U20,25,8,13,21,69,17,12572
2006-07,HC Vsetin,Czech,37,1,1,2,20,-18,12572
2006-07,Czech Republic U18,WJC-18,6,1,1,2,4,-3,12572
2006-07,Czech Republic U18 (all),International-Jr,14,2,3,5,12,,12572
2006-07,Czech Republic U20 (all),International-Jr,3,0,0,0,0,,12572
2006-07,Tappara U20,Jr. A SM-liiga,39,9,21,30,38,12,10246
2006-07,Tappara,Liiga,7,0,0,0,2,0,10246
2006-07,Suomi U20,Mestis,10,0,2,2,12,-2,10246
2006-07,Sault Ste. Marie Greyhounds,OHL,68,34,58,92,40,7,11115
2006-07,Erie Otters,OHL,58,5,8,13,136,-24,15037
2006-07,Avon Old Farms School,USHS-Prep,26,24,42,66,14,,14686
2006-07,DEG Metro Stars,DEL,52,3,19,22,28,8,13633
2006-07,Germany,WC,6,2,2,4,2,-2,13633
2006-07,Germany (all),International,11,3,2,5,4,,13633
2006-07,U.S. National U18 Team,USDP,32,6,14,20,10,,11462
2006-07,U.S. National U18 Team,NAHL,15,4,9,13,4,,11462
2006-07,USA U18,WJC-18,7,1,2,3,2,0,11462
2006-07,Academy of Holy Angels,USHS-MN,13,-,-,36,-,,12562
2006-07,Des Moines Buccaneers,USHL,10,1,2,3,6,-3,12562
2006-07,Pelicans U20,Jr. A SM-liiga,33,18,21,39,40,1,7571
2006-07,Pelicans,Liiga,7,1,0,1,0,0,7571
2006-07,Suomi U20,Mestis,6,1,1,2,4,-1,7571
2006-07,Finland U20,WJC-20,6,0,0,0,4,0,7571
2006-07,Saginaw Spirit,OHL,22,10,13,23,24,-1,11401
2006-07,Erie Otters,OHL,43,20,26,46,69,-23,11401
2006-07,Canada U18,WJC-18,6,0,3,3,2,-1,11401
2006-07,Gatineau Olympiques,QMJHL,68,21,23,44,46,7,15036
2006-07,Wellington Dukes,OPJHL,37,20,32,52,36,,14011
2006-07,London Knights,OHL,31,6,12,18,18,4,14011
2006-07,London Knights,OHL,34,0,2,2,29,-10,11239
2006-07,Guelph Storm,OHL,27,5,9,14,32,-1,11239
2006-07,Erie Otters,OHL,64,9,18,27,96,-36,13606
2006-07,Hill-Murray School,USHS-MN,-,31,30,61,-,,18600
2006-07,Omaha Lancers,USHL,10,3,2,5,6,3,18600
2006-07,U.S. National U18 Team,USDP,33,6,7,13,28,,11467
2006-07,U.S. National U18 Team,NAHL,15,0,3,3,22,,11467
2006-07,USA U18,WJC-18,7,2,1,3,4,3,11467
2006-07,St. John's Fog Devils,QMJHL,63,18,18,36,118,-28,12171
2006-07,Red Deer Rebels,WHL,33,10,7,17,54,11,11662
2006-07,Moose Jaw Warriors,WHL,39,13,26,39,44,8,11662
2006-07,Compuware U18,T1EHL U18,24,6,10,16,23,,12587
2006-07,Cambridge Winter Hawks,MWJHL,37,27,29,56,55,,15035
2006-07,Virginia/Mountain Iron-Buhl High,USHS-MN,-,14,34,48,-,,14396
2006-07,Rimouski Océanic,QMJHL,52,14,21,35,62,-4,12542
2006-07,Slovakia U20,WJC-20,6,0,2,2,22,1,12542
2006-07,Linköping HC J20,SuperElit,6,0,5,5,6,6,2621
2006-07,Linköping HC,SHL,30,2,2,4,8,3,2621
2006-07,VIK Västerås HK,Allsvenskan,15,2,3,5,14,7,2621
2006-07,Brynäs IF J20,SuperElit,26,17,29,46,46,13,3415
2006-07,Brynäs IF,SHL,32,0,0,0,0,1,3415
2006-07,IFK Arboga,Allsvenskan,2,0,0,0,2,0,3415
2006-07,Sweden U19 (all),International-Jr,8,2,4,6,14,,3415
2006-07,Shawinigan Cataractes,QMJHL,60,11,27,38,66,-11,12556
2006-07,Lewiston MAINEiacs,QMJHL,58,0,7,7,39,7,15034
2006-07,Lewiston MAINEiacs,M-Cup,3,0,0,0,0,-1,15034
2006-07,Ohio Junior Blue Jackets,USHL,60,10,11,21,36,-28,14389
2006-07,Nobles Prep,USHS-Prep,18,7,10,17,-,,20907
2006-07,Calgary Hitmen,WHL,72,7,15,22,76,-1,13595
2006-07,UMass (Amherst),NCAA,39,4,10,14,20,4,15033
2006-07,Portland Winter Hawks,WHL,61,19,12,31,186,-23,14501
2006-07,Swift Current Broncos,WHL,70,5,19,24,42,-19,15032
2006-07,Prince George Cougars,WHL,13,2,5,7,18,1,13603
2006-07,Everett Silvertips,WHL,48,20,22,42,44,19,13603
2006-07,Swift Current Broncos,WHL,61,1,4,5,52,-15,13929
2006-07,Lindsay Muskies,OPJHL,31,11,21,32,28,,15031
2006-07,Taft School,USHS-Prep,24,3,13,16,-,,14401
2006-07,Victoria Grizzlies,BCHL,5,0,0,0,14,,12540
2006-07,Coquitlam Express,BCHL,53,5,9,14,69,,12540
2006-07,St. Louis Bandits,NAHL,31,10,16,26,24,,14385
2007-08,Sarnia Sting,OHL,61,58,47,105,88,18,11113
2007-08,Canada U20,WJC-20,7,1,5,6,4,1,11113
2007-08,Canada U18,Hlinka Memorial,4,1,4,5,16,,11113
2007-08,Guelph Storm,OHL,58,13,37,50,68,-1,10430
2007-08,Canada U20,WJC-20,7,0,4,4,0,0,10430
2007-08,Canada U20,Super Series,8,0,2,2,4,,10430
2007-08,Peterborough Petes,OHL,60,11,50,61,72,8,14440
2007-08,Niagara IceDogs,OHL,60,13,40,53,94,29,11317
2007-08,Kelowna Rockets,WHL,57,7,21,28,100,5,11400
2007-08,Canada U20,WJC-20,7,0,0,0,6,5,11400
2007-08,Canada U20,Super Series,8,0,0,0,20,,11400
2007-08,CSKA Moskva,Russia,5,0,0,0,0,-2,11860
2007-08,CSKA Moskva-2,Russia3,23,24,23,47,62,,11860
2007-08,Russia U18,WJC-18,6,3,6,9,29,1,11860
2007-08,Russia U20,WJC-20,7,4,5,9,10,7,11860
2007-08,Russia U19,WJAC-19,4,3,3,6,10,,11860
2007-08,Russia U18,Hlinka Memorial,4,2,1,3,8,-1,11860
2007-08,Boston Univ.,NCAA,37,12,23,35,22,10,9325
2007-08,USA U20,WJC-20,6,6,1,7,4,2,9325
2007-08,Kitchener Rangers,OHL,62,29,44,73,14,6,5996
2007-08,Denmark U20,WJC-20,6,2,4,6,2,-7,5996
2007-08,Kitchener Rangers,M-Cup,5,2,4,6,0,-3,5996
2007-08,Windsor Spitfires,OHL,67,29,67,96,32,30,14013
2007-08,Brampton Battalion,OHL,68,40,45,85,36,15,11253
2007-08,Canada U18,WJC-18,7,2,10,12,8,2,11253
2007-08,Canada U18,Hlinka Memorial,4,2,3,5,4,,11253
2007-08,Everett Silvertips,WHL,60,27,33,60,222,-4,11054
2007-08,Kelowna Rockets,WHL,65,6,13,19,97,-16,17521
2007-08,Canada U18,WJC-18,7,1,1,2,10,7,17521
2007-08,Regina Pats,WHL,66,7,16,23,135,-8,13625
2007-08,Canada U18,WJC-18,7,0,1,1,30,8,13625
2007-08,Canada U18,Hlinka Memorial,4,0,0,0,8,,13625
2007-08,Lethbridge Hurricanes,WHL,61,33,39,72,80,26,11057
2007-08,Canada U20,WJC-20,7,0,0,0,2,0,11057
2007-08,Canada U20,Super Series,7,4,2,6,12,,11057
2007-08,Frölunda HC J18,J18 Elit,2,1,1,2,0,0,9878
2007-08,Frölunda HC J18,J18 Allsvenskan,1,0,1,1,2,0,9878
2007-08,Frölunda HC J20,SuperElit,38,13,24,37,68,11,9878
2007-08,Frölunda HC,SHL,7,1,0,1,0,2,9878
2007-08,Sweden U18,WJC-18,6,0,7,7,4,8,9878
2007-08,Sweden U18 (all),International-Jr,17,3,11,14,22,,9878
2007-08,Camrose Kodiaks,AJHL,55,33,57,90,48,,18593
2007-08,Camrose Kodiaks,Doyle Cup,5,4,3,7,6,,18593
2007-08,Camrose Kodiaks,RBC Cup,5,1,4,5,4,,18593
2007-08,Canada West U19,WJAC-19,5,3,4,7,2,,18593
2007-08,Minnetonka High,USHS-MN,24,20,28,48,14,,18592
2007-08,Team Southwest,USHS-MN,11,8,7,15,-,,18592
2007-08,Lethbridge Hurricanes,WHL,62,6,27,33,63,19,13946
2007-08,Switzerland U18 (all),International-Jr,7,1,2,3,0,,13946
2007-08,Switzerland U20,WJC-20,6,0,0,0,4,-1,13946
2007-08,Switzerland U20 (all),International-Jr,8,0,0,0,4,,13946
2007-08,Oshawa Generals,OHL,64,16,47,63,82,7,12112
2007-08,Frölunda HC J18,J18 Allsvenskan,1,0,1,1,2,,6058
2007-08,Frölunda HC J20,SuperElit,33,15,17,32,55,,6058
2007-08,Frölunda HC,SHL,1,0,0,0,0,0,6058
2007-08,Sweden U18 (all),International-Jr,3,1,2,3,8,,6058
2007-08,Regina Pats,WHL,70,42,33,75,20,5,11098
2007-08,Canada U18,WJC-18,7,4,6,10,0,2,11098
2007-08,Canada U18,Hlinka Memorial,4,0,0,0,0,,11098
2007-08,Ottawa 67's,OHL,59,4,28,32,69,4,15385
2007-08,Canada U18,WJC-18,7,2,3,5,6,1,15385
2007-08,HV71 J18,J18 Elit,1,1,0,1,0,,6013
2007-08,HV71 J20,SuperElit,25,14,16,30,14,,6013
2007-08,HV71,SHL,23,3,3,6,6,5,6013
2007-08,Sweden U18,WJC-18,6,4,4,8,35,1,6013
2007-08,Sweden U18 (all),International-Jr,14,10,8,18,53,,6013
2007-08,Sweden U20 (all),International-Jr,3,0,0,0,0,,6013
2007-08,Windsor Spitfires,OHL,68,34,33,67,52,28,14359
2007-08,Canada U18,WJC-18,7,2,1,3,6,2,14359
2007-08,Medicine Hat Tigers,WHL,70,43,48,91,42,11,11667
2007-08,Indiana Ice,USHL,59,12,31,43,72,11,18590
2007-08,Severstal Cherepovets,Russia,43,7,5,12,43,-1,15235
2007-08,Russia U20,WJC-20,7,5,2,7,6,-1,15235
2007-08,Russia U20,Super Series,4,0,0,0,12,,15235
2007-08,St. Catharines Falcons,GHL,45,29,27,56,38,,18599
2007-08,Traktor Chelyabinsk,Russia,36,1,3,4,20,1,10627
2007-08,Traktor Chelyabinsk-2,Russia3,2,1,0,1,0,,10627
2007-08,Russia U18,WJC-18,6,1,4,5,2,1,10627
2007-08,Russia U20,WJC-20,7,0,1,1,0,1,10627
2007-08,Russia U20,Super Series,8,1,1,2,17,,10627
2007-08,Russia U18,Hlinka Memorial,4,0,1,1,6,-2,10627
2007-08,Russia U19,WJAC-19,4,1,1,2,0,,10627
2007-08,London Knights,OHL,66,18,28,46,61,-5,13499
2007-08,USA U18,WJC-18,7,3,3,6,4,4,13499
2007-08,Chicoutimi Saguenéens,QMJHL,70,24,43,67,63,12,16713
2007-08,Canada U18,WJC-18,7,3,0,3,2,4,16713
2007-08,Stouffville Spirit,OPJHL,39,19,50,69,22,,17517
2007-08,Canada U18,WJC-18,7,4,3,7,2,6,17517
2007-08,Canada East U19,WJAC-19,5,2,3,5,0,,17517
2007-08,Univ. of Wisconsin,NCAA,40,4,6,10,36,-1,18594
2007-08,Bern U20,Elite Jr. A,0,0,0,0,0,,12668
2007-08,SC Bern,NLA,35,2,6,8,10,,12668
2007-08,HC Neuchâtel Young Sprinters,NLB,3,2,0,2,4,,12668
2007-08,Schweiz U-20,NLB,2,0,1,1,0,,12668
2007-08,Switzerland U18,WJC-18,6,1,4,5,4,1,12668
2007-08,Switzerland U18 (all),International-Jr,14,2,7,9,6,,12668
2007-08,Switzerland U20,WJC-20,6,0,1,1,4,-3,12668
2007-08,Switzerland U20 (all),International-Jr,11,0,2,2,4,,12668
2007-08,Cumberland Grads,CJHL,34,23,33,56,12,,17515
2007-08,Sudbury Wolves,OHL,26,14,18,32,19,10,17515
2007-08,Canada U18,WJC-18,7,1,3,4,8,2,17515
2007-08,Great Plains,USHS-MN,11,2,11,13,-,,17497
2007-08,Roseau High,USHS-MN,31,28,44,72,16,,17497
2007-08,U.S. National U18 Team,USDP,9,0,6,6,2,,17497
2007-08,USA U18,WJC-18,7,0,6,6,2,5,17497
2007-08,Saint John Sea Dogs,QMJHL,69,6,15,21,92,1,11318
2007-08,Omaha Lancers,USHL,40,3,18,21,24,12,15528
2007-08,Westside Warriors,BCHL,57,9,31,40,28,,18241
2007-08,St. John's Fog Devils,QMJHL,70,36,30,66,72,9,13785
2007-08,Penticton Vees,BCHL,46,27,36,63,14,,18240
2007-08,Penticton Vees,Doyle Cup,5,2,2,4,2,,18240
2007-08,Canada West U19,WJAC-19,5,5,2,7,2,,18240
2007-08,Brandon Wheat Kings,WHL,71,6,24,30,25,-6,17518
2007-08,Canada U18,WJC-18,7,0,1,1,8,2,17518
2007-08,Québec Remparts,QMJHL,38,12,20,32,22,11,17514
2007-08,Val-d'Or Foreurs,QMJHL,32,14,19,33,8,0,17514
2007-08,Canada U18,WJC-18,7,0,6,6,2,4,17514
2007-08,Spokane Chiefs,WHL,67,20,53,73,63,33,11102
2007-08,Spokane Chiefs,M-Cup,4,2,4,6,2,5,11102
2007-08,Sudbury Wolves,OHL,60,21,28,49,44,-11,10158
2007-08,Mississauga St. Michael's Majors,OHL,63,10,30,40,99,-1,16591
2007-08,Shattuck St. Mary's Midget Prep,USHS-Prep,60,44,67,111,22,,19040
2007-08,St. Michael's Buzzers,OPJHL,32,7,17,24,41,,18597
2007-08,Canada East U19,WJAC-19,5,0,2,2,14,,18597
2007-08,Moose Jaw Warriors,WHL,61,5,17,22,101,5,17519
2007-08,Canada U18,WJC-18,7,0,2,2,14,4,17519
2007-08,Rimouski Océanic,QMJHL,51,18,23,41,84,11,19042
2007-08,Val-d'Or Foreurs,QMJHL,65,4,10,14,35,-22,17520
2007-08,Canada U18,WJC-18,7,1,1,2,6,7,17520
2007-08,U.S. National U17 Team,USDP,2,1,1,2,2,,17504
2007-08,U.S. National U18 Team,NAHL,14,4,4,8,6,2,17504
2007-08,U.S. National U18 Team,USDP,41,17,13,30,43,,17504
2007-08,USA U18,WJC-18,7,3,3,6,2,5,17504
2007-08,Tri-City Americans,WHL,71,2,14,16,65,9,19041
2007-08,CSKA Moskva-2,Russia3,29,25,25,50,60,,11865
2007-08,Russia U18,WJC-18,3,2,1,3,4,2,11865
2007-08,Russia U20,WJC-20,7,1,3,4,4,3,11865
2007-08,Russia U18,Hlinka Memorial,4,1,1,2,6,2,11865
2007-08,Russia U19,WJAC-19,4,3,2,5,4,,11865
2007-08,U.S. National U18 Team,USDP,23,2,6,8,6,,11463
2007-08,U.S. National U18 Team,NAHL,19,2,8,10,6,6,11463
2007-08,Lincoln Stars,USHL,21,4,11,15,18,9,11463
2007-08,USA U19,WJAC-19,4,1,2,3,2,,11463
2007-08,Kent School,USHS-Prep,25,17,37,54,10,,19060
2007-08,U.S. National U18 Team,USDP,43,15,18,33,30,,17501
2007-08,U.S. National U18 Team,NAHL,14,4,2,6,12,5,17501
2007-08,USA U18,WJC-18,7,3,5,8,10,7,17501
2007-08,Lewiston MAINEiacs,QMJHL,63,29,13,42,213,8,12401
2007-08,Tappara,Liiga,54,13,29,42,32,12,8042
2007-08,Finland,EHT,2,0,0,0,0,0,8042
2007-08,Shattuck St. Mary's Midget Prep,USHS-Prep,51,44,56,100,20,,15018
2007-08,Rouyn-Noranda Huskies,QMJHL,69,12,47,59,114,39,19078
2007-08,Belleville Bulls,OHL,66,9,22,31,67,28,11246
2007-08,Belleville Bulls,M-Cup,4,0,3,3,10,-3,11246
2007-08,Canada U18,Hlinka Memorial,4,1,3,4,16,,11246
2007-08,Calgary Hitmen,WHL,71,10,25,35,28,3,11708
2007-08,Sault Ste. Marie Greyhounds,OHL,68,21,23,44,135,10,14091
2007-08,Kingston Frontenacs,OHL,68,28,23,51,106,-14,15705
2007-08,Canada U18,WJC-18,7,0,1,1,4,1,15705
2007-08,Saskatoon Blades,WHL,49,14,20,34,57,-1,12570
2007-08,Ak Bars Kazan,Russia,47,4,6,10,54,6,11870
2007-08,Ak Bars Kazan-2,Russia3,-,6,11,17,-,,11870
2007-08,Russia U18,WJC-18,6,5,2,7,6,-2,11870
2007-08,Russia U19,WJAC-19,4,1,2,3,0,,11870
2007-08,Sault Ste. Marie Greyhounds,OHL,68,13,22,35,64,20,19222
2007-08,Lokomotiv Yaroslavl-2,Russia3,34,17,20,37,18,,16752
2007-08,Lokomotiv Yaroslavl,Russia,1,0,0,0,0,0,16752
2007-08,Russia U18,WJC-18,6,2,3,5,2,3,16752
2007-08,Russia U18,Hlinka Memorial,4,2,2,4,14,1,16752
2007-08,Russia U19,WJAC-19,4,3,2,5,0,,16752
2007-08,Cape Breton Screaming Eagles,QMJHL,69,1,6,7,27,-1,19045
2007-08,Vancouver Giants,WHL,71,12,23,35,93,10,16499
2007-08,Swift Current Broncos,WHL,72,22,48,70,136,31,14495
2007-08,Manitoba Moose,AHL,0,0,0,0,0,,14495
2007-08,Saginaw Spirit,OHL,58,10,18,28,90,17,18598
2007-08,Eastview High (MN),USHS-MN,24,6,6,12,76,,18596
2007-08,Team Southwest,USHS-MN,12,2,4,6,-,,18596
2007-08,Indiana Ice,USHL,12,1,2,3,12,5,18596
2007-08,Windsor Spitfires,OHL,66,20,24,44,28,17,19043
2007-08,Kelowna Rockets,WHL,71,15,26,41,56,-5,14741
2007-08,Canada U18,WJC-18,7,1,2,3,6,3,14741
2007-08,Sioux City Musketeers,USHL,60,19,30,49,55,16,15531
2007-08,Calgary Hitmen,WHL,67,15,15,30,128,10,19054
2007-08,Swift Current Broncos,WHL,66,20,24,44,72,10,19047
2007-08,Russell Stover U18,Midget,70,40,52,92,36,,18120
2007-08,Norway U18,WJC-18 D1,5,2,5,7,4,6,18120
2007-08,HC Trinec U20,Czech U20,14,3,6,9,28,5,13651
2007-08,HC Trinec,Czech,14,0,1,1,10,1,13651
2007-08,HC Havirov,Czech2,2,0,0,0,2,-2,13651
2007-08,LHK Jestřábi Prostějov,Czech2,16,1,0,1,12,-10,13651
2007-08,Czech Republic U20,WJC-20,6,1,0,1,2,-1,13651
2007-08,Czech Republic U20 (all),International-Jr,16,1,0,1,12,,13651
2007-08,Czech Republic (all),International,4,0,0,0,2,,13651
2007-08,Chicago Steel,USHL,58,6,14,20,78,7,15519
2007-08,USA U19,WJAC-19,4,0,1,1,28,,15519
2007-08,Québec Remparts,QMJHL,70,5,20,25,100,5,19048
2007-08,U.S. National U17 Team,USDP,1,0,3,3,0,,11465
2007-08,U.S. National U18 Team,USDP,42,12,16,28,49,5,11465
2007-08,U.S. National U18 Team,NAHL,15,1,7,8,0,5,11465
2007-08,USA U18,WJC-18,7,0,3,3,33,4,11465
2007-08,U.S. National U18 Team,USDP,41,5,29,34,26,,17499
2007-08,U.S. National U18 Team,NAHL,15,4,2,6,8,4,17499
2007-08,USA U18,WJC-18,7,0,7,7,8,6,17499
2007-08,Cedar Rapids Roughriders,USHL,59,12,18,30,41,19,14126
2007-08,Guelph Storm,OHL,20,9,4,13,16,-2,11388
2007-08,Sarnia Sting,OHL,40,18,16,34,22,-10,11388
2007-08,HK Gomel,Belarus,1,0,0,0,0,,9289
2007-08,Québec Remparts,QMJHL,62,32,34,66,32,0,9289
2007-08,Belarus U20,WJC-20 D1,5,3,1,4,2,2,9289
2007-08,Belarus (all),International,1,0,0,0,0,,9289
2007-08,HK Gomel,Belarus Cup,8,6,0,6,10,,9289
2007-08,Kelowna Rockets,WHL,72,31,69,100,41,22,14504
2007-08,Plymouth Whalers,OHL,68,26,29,55,94,-13,14643
2007-08,Cloquet High,USHS-MN,25,21,18,39,58,,18851
2007-08,Team North,USHS-MN,12,5,13,18,-,,18851
2007-08,HV71 J20,SuperElit,40,27,27,54,86,,6913
2007-08,HV71,SHL,7,0,0,0,0,0,6913
2007-08,Sweden U19 (all),International-Jr,8,3,3,6,2,,6913
2007-08,Färjestad BK,SHL,28,0,2,2,10,-10,6953
2007-08,Bofors IK,Allsvenskan,15,2,3,5,18,-3,6953
2007-08,Skåre BK,Division 1,3,0,2,2,2,,6953
2007-08,Sweden U19 (all),International-Jr,1,0,0,0,0,,6953
2007-08,Sweden U20,WJC-20,6,0,0,0,6,5,6953
2007-08,Sweden U20 (all),International-Jr,15,0,2,2,16,,6953
2007-08,Prince Edward Island Rocket,QMJHL,69,12,19,31,70,-10,19076
2007-08,Windsor Spitfires,OHL,22,1,5,6,12,7,12567
2007-08,Plymouth Whalers,OHL,39,5,17,22,32,-5,12567
2007-08,Czech Republic U18,WJC-18 D1,5,0,5,5,6,5,12567
2007-08,Czech Republic U18 (all),International-Jr,5,0,5,5,6,,12567
2007-08,Czech Republic U20,WJC-20,6,0,1,1,4,4,12567
2007-08,Czech Republic U20 (all),International-Jr,6,0,1,1,4,,12567
2007-08,Gatineau Olympiques,QMJHL,70,6,23,29,89,8,19181
2007-08,Gatineau Olympiques,M-Cup,3,0,0,0,4,-1,19181
2007-08,Waterloo Black Hawks,USHL,57,19,19,38,66,0,14399
2007-08,USA U19,WJAC-19,4,1,0,1,4,,14399
2007-08,HV71 J18,J18 Elit,2,3,4,7,4,,7039
2007-08,HV71 J18,J18 Allsvenskan,1,1,1,2,0,,7039
2007-08,HV71 J20,SuperElit,36,16,22,38,34,,7039
2007-08,Sweden U18,WJC-18,6,4,4,8,2,4,7039
2007-08,Sweden U18 (all),International-Jr,14,7,6,13,6,,7039
2007-08,Québec Remparts,QMJHL,68,36,45,81,73,19,13497
2007-08,Swift Current Broncos,WHL,53,29,22,51,84,8,15727
2007-08,Regina Pats,WHL,68,3,16,19,68,7,19044
2007-08,U.S. National U18 Team,USDP,41,5,8,13,38,,17494
2007-08,U.S. National U18 Team,NAHL,14,2,8,10,18,7,17494
2007-08,USA U18,WJC-18,7,0,3,3,8,5,17494
2007-08,Saginaw Spirit,OHL,68,4,26,30,73,2,19170
2007-08,U.S. National U18 Team,USDP,43,2,4,6,20,,17496
2007-08,U.S. National U18 Team,NAHL,14,2,1,3,4,4,17496
2007-08,USA U18,WJC-18,7,0,0,0,0,5,17496
2007-08,Vancouver Giants,WHL,60,13,23,36,21,4,18595
2007-08,Langley Chiefs,BCHL,57,24,39,63,44,,18242
2007-08,Kingston Frontenacs,OHL,68,35,42,77,79,-25,14431
2007-08,Malmö Redhawks J20,SuperElit,24,11,20,31,20,-9,6223
2007-08,Sweden U19 (all),International-Jr,5,1,0,1,6,,6223
2007-08,Lokomotiv Yaroslavl,Russia,5,0,1,1,0,0,11867
2007-08,Lokomotiv Yaroslavl-2,Russia3,31,8,22,30,8,,11867
2007-08,Russia U18,WJC-18,6,3,5,8,29,0,11867
2007-08,Russia U18 (all),International-Jr,18,7,13,20,37,,11867
2007-08,Russia U18,Hlinka Memorial,4,2,3,5,6,3,11867
2007-08,Russia U19,WJAC-19,4,1,3,4,2,,11867
2007-08,Frölunda HC J20,SuperElit,41,19,34,53,42,,5016
2007-08,Frölunda HC,SHL,2,0,0,0,0,1,5016
2007-08,Sweden U19 (all),International-Jr,9,2,3,5,8,,5016
2007-08,IF Björklöven J20,SuperElit,1,0,0,0,0,,3705
2007-08,IF Björklöven,Allsvenskan,42,4,21,25,14,10,3705
2007-08,Sweden U20,WJC-20,6,0,1,1,2,-1,3705
2007-08,Sweden U20 (all),International-Jr,18,0,8,8,24,,3705
2007-08,Sweden (all),International,3,0,1,1,6,2,3705
2007-08,Brandon Wheat Kings,WHL,72,24,40,64,53,26,17025
2007-08,Ohio Junior Blue Jackets,USHL,60,3,24,27,145,-1,15526
2007-08,Chicoutimi Saguenéens,QMJHL,70,18,22,40,45,1,19046
2007-08,Kölner EC U18,DNL,32,32,41,73,62,,11844
2007-08,Kölner Haie,DEL,30,0,1,1,4,1,11844
2007-08,Germany U18,WJC-18,6,1,2,3,6,-1,11844
2007-08,Germany U20,WJC-20 D1,5,3,3,6,4,5,11844
2007-08,Germany U20 (all),International-Jr,14,5,7,12,14,,11844
2007-08,Seattle Thunderbirds,WHL,72,20,45,65,21,31,15590
2007-08,Saskatoon Blades,WHL,69,4,15,19,104,-28,19183
2007-08,Rimouski Océanic,QMJHL,61,23,26,49,24,14,19051
2007-08,Chicoutimi Saguenéens,QMJHL,67,23,39,62,40,22,17516
2007-08,Canada U18,WJC-18,7,1,2,3,10,4,17516
2007-08,HC Plzen U20,Czech U20,22,8,13,21,50,2,11834
2007-08,HC Plzen,Czech,20,2,1,3,8,0,11834
2007-08,HC Berounsti Medvedi,Czech2,6,0,0,0,0,-4,11834
2007-08,Czech Republic U18,WJC-18 D1,5,6,6,12,8,9,11834
2007-08,Czech Republic U18 (all),International-Jr,13,9,8,17,26,,11834
2007-08,Czech Republic U20 (all),International-Jr,3,0,0,0,6,,11834
2007-08,Langley Chiefs,BCHL,57,33,48,81,71,,18243
2007-08,Vancouver Giants,WHL,72,8,39,47,45,11,14962
2007-08,Severstal Cherepovets,Russia,1,0,0,0,0,0,19034
2007-08,Severstal Cherepovets-2,Russia3,39,27,25,52,58,,19034
2007-08,Smiths Falls Bears,CJHL,46,2,24,26,80,,19223
2007-08,Northern Michigan Univ.,NCAA,39,21,17,38,59,7,15566
2007-08,Prince Edward Island Rocket,QMJHL,63,27,36,63,81,-18,12120
2007-08,Oshawa Generals,OHL,57,5,12,17,47,-2,19224
2007-08,VIK Västerås HK J18,J18 Allsvenskan,1,0,0,0,12,,6870
2007-08,VIK Västerås HK J20,SuperElit,33,2,6,8,62,,6870
2007-08,VIK Västerås HK,Allsvenskan,0,0,0,0,0,,6870
2007-08,Tri-City Americans,WHL,3,2,1,3,2,1,11607
2007-08,Moose Jaw Warriors,WHL,70,28,22,50,72,-2,11607
2007-08,Lukko U18,Jr. B SM-sarja Q,2,2,2,4,0,,17014
2007-08,Lukko U18,Jr. B SM-sarja,5,2,3,5,2,,17014
2007-08,Lukko U20,Jr. A SM-liiga,42,12,15,27,34,3,17014
2007-08,Finland U18 (all),International-Jr,3,0,1,1,12,,17014
2007-08,Ottawa 67's,OHL,65,5,28,33,94,-5,19050
2007-08,Brampton Battalion,OHL,66,10,12,22,48,-9,19070
2007-08,Sarnia Sting,OHL,66,25,13,38,155,3,19225
2007-08,Frölunda HC J20,SuperElit,8,1,4,5,12,5,6006
2007-08,Frölunda HC,SHL,16,0,0,0,2,-1,6006
2007-08,Borås HC,Allsvenskan,24,5,5,10,32,-10,6006
2007-08,Denmark U20,WJC-20,6,1,1,2,6,-13,6006
2007-08,Northwood School Prep,USHS-Prep,42,24,32,56,56,,19077
2007-08,Moncton Wildcats,QMJHL,70,11,35,46,75,-3,19148
2007-08,Kitchener Rangers,OHL,67,43,81,124,69,24,9347
2007-08,Kitchener Rangers,M-Cup,5,4,7,11,2,8,9347
2007-08,Guelph Storm,OHL,67,24,24,48,65,1,11241
2007-08,Spokane Chiefs,WHL,69,12,31,43,19,36,11611
2007-08,Spokane Chiefs,M-Cup,4,0,1,1,0,2,11611
2007-08,Avon Old Farms School,USHS-Prep,28,26,37,63,10,,19166
2007-08,Penticton Vees,BCHL,54,24,48,72,52,,18247
2007-08,Penticton Vees,Doyle Cup,5,2,1,3,14,,18247
2007-08,Canada West U19,WJAC-19,5,1,4,5,4,,18247
2007-08,Ohio Junior Blue Jackets,USHL,58,3,10,13,139,-10,19227
2007-08,Linköping HC J20,SuperElit,35,18,18,36,41,,6251
2007-08,Linköping HC,SHL,2,0,0,0,0,0,6251
2007-08,Nyköpings HK,Allsvenskan,2,0,1,1,2,1,6251
2007-08,Norway U20,WJC-20 D1,5,4,3,7,6,0,6251
2007-08,Norway,WC,7,0,0,0,4,-3,6251
2007-08,Norway (all),International,14,1,5,6,12,,6251
2007-08,Brynäs IF J20,SuperElit,8,3,2,5,6,,3706
2007-08,Brynäs IF,SHL,26,0,0,0,27,-8,3706
2007-08,IF Björklöven,Allsvenskan,16,2,3,5,6,3,3706
2007-08,Sweden U20,WJC-20,6,1,1,2,2,-3,3706
2007-08,Sweden U20 (all),International-Jr,15,2,3,5,4,,3706
2007-08,KalPa U18,Jr. B SM-sarja,7,9,6,15,6,,11365
2007-08,KalPa U20,Jr. A SM-liiga,37,10,7,17,24,-2,11365
2007-08,KalPa,Liiga,1,0,0,0,0,-1,11365
2007-08,Finland U18,WJC-18,6,2,1,3,6,2,11365
2007-08,Finland U18 (all),International-Jr,13,6,3,9,12,,11365
2007-08,Saginaw Spirit,OHL,68,4,16,20,58,-1,19233
2007-08,RPI (Rensselaer Polytech. Inst.),NCAA,38,1,3,4,28,-5,19232
2007-08,Victoriaville Tigres,QMJHL,69,7,28,35,95,-13,13783
2007-08,Moose Jaw Warriors,WHL,66,10,9,19,163,-6,19231
2007-08,Boston College,NCAA,44,25,25,50,12,18,15068
2007-08,Sparta Sarpsborg,Norway,40,2,20,22,67,,15713
2007-08,Norway,WC,7,0,1,1,6,-7,15713
2007-08,Norway (all),International,20,0,2,2,34,,15713
2007-08,Erie Otters,OHL,20,2,5,7,19,-10,19228
2007-08,U.S. National U17 Team,USDP,6,5,1,6,4,,17509
2007-08,U.S. National U18 Team,NAHL,22,10,5,15,27,11,17509
2007-08,U.S. National U18 Team,USDP,31,4,6,10,44,,17509
2007-08,USA U18,WJC-18,7,3,0,3,16,3,17509
2007-08,Smiths Falls Bears,CJHL,57,51,59,110,67,,18875
2007-08,New Hampshire Jr. Monarchs,EJHL,40,21,25,46,46,,19159
2007-08,Sarnia Sting,OHL,58,39,54,93,61,12,13844
2007-08,Swift Current Broncos,WHL,60,19,17,36,111,16,19058
2007-08,Miami Univ. (Ohio),NCAA,42,15,14,29,22,10,19230
2007-08,Mississauga St. Michael's Majors,OHL,63,7,7,14,191,-14,19073
2007-08,Drayton Valley Thunder,AJHL,-,-,-,-,-,,19229
2007-08,Nanaimo Clippers,BCHL,19,0,2,2,15,,19229
2007-08,Oakville Blades,OPJHL,13,1,4,5,6,,19229
2007-08,Oakville Blades,Dudley Hewitt Cup,4,1,1,2,0,,19229
2007-08,Oakville Blades,RBC Cup,4,0,2,2,2,,19229
2007-08,Belleville Bulls,OHL,56,2,7,9,12,0,19061
2007-08,Belleville Bulls,M-Cup,4,0,0,0,0,0,19061
2007-08,Ilves U18,Jr. B SM-sarja Q,2,1,0,1,0,,16048
2007-08,Ilves U18,Jr. B SM-sarja,10,8,6,14,6,,16048
2007-08,Ilves U20,Jr. A SM-liiga,41,21,19,40,38,17,16048
2007-08,Finland U18,WJC-18,6,3,0,3,8,-6,16048
2007-08,Finland U18 (all),International-Jr,13,4,2,6,12,,16048
2007-08,St. Cloud State Univ.,NCAA,39,18,27,45,55,-8,14867
2007-08,Ferris State Univ.,NCAA,37,6,13,19,37,15,12189
2007-08,Victoriaville Tigres,QMJHL,67,9,55,64,91,-6,12154
2007-08,Waywayseecappo Wolverines,MJHL,60,51,64,115,34,,19204
2007-08,Camrose Kodiaks,AJHL,54,0,13,13,130,,19165
2007-08,Camrose Kodiaks,Doyle Cup,5,0,3,3,8,,19165
2007-08,Camrose Kodiaks,RBC Cup,6,1,0,1,6,,19165
2007-08,Mississauga St. Michael's Majors,OHL,68,5,22,27,95,-8,19151
2007-08,Lincoln Stars,USHL,60,4,37,41,135,19,16707
2007-08,Edina High,USHS-MN,23,9,33,42,-,,18885
2007-08,Team Southwest,USHS-MN,12,6,14,20,-,,18885
2007-08,Medicine Hat Tigers,WHL,72,6,19,25,160,8,11669
2007-08,Kent School,USHS-Prep,25,12,36,47,14,,19066
2007-08,Baie-Comeau Drakkar,QMJHL,68,23,19,42,54,16,19074
2007-08,Choate Rosemary Hall,USHS-Prep,21,15,21,36,10,,19063
2007-08,U.S. National U18 Team,NAHL,5,1,1,2,2,-3,19063
2007-08,Djurgårdens IF J20,SuperElit,38,6,12,18,70,,5507
2007-08,Sweden U19 (all),International-Jr,8,0,0,0,2,,5507
2007-08,Brynäs IF J20,SuperElit,28,10,25,35,50,,3707
2007-08,Brynäs IF,SHL,19,0,4,4,0,0,3707
2007-08,Wausau West High,USHS-WI,23,33,26,59,10,,19049
2007-08,Team Wisconsin,USHS-WI,24,20,25,45,6,,19049
2007-08,Blues U18,Jr. B SM-sarja,1,1,0,1,2,,15653
2007-08,Blues U20,Jr. A SM-liiga,25,4,10,14,14,11,15653
2007-08,Blues,Liiga,1,0,0,0,0,0,15653
2007-08,Finland U18,WJC-18,6,1,0,1,2,1,15653
2007-08,Finland U18 (all),International-Jr,13,2,2,4,6,,15653
2007-08,Windsor Spitfires,OHL,68,2,12,14,155,13,19075
2007-08,Shattuck St. Mary's Midget Prep,USHS-Prep,61,13,38,51,61,,15017
2007-08,Barrie Colts,OHL,68,13,19,32,171,-14,19171
2007-08,Rouyn-Noranda Huskies,QMJHL,64,12,12,24,118,18,19177
2007-08,Univ. of Wisconsin,NCAA,40,8,13,21,36,9,19237
2007-08,U.S. National U18 Team,USDP,41,3,9,12,6,,17498
2007-08,U.S. National U18 Team,NAHL,12,0,2,2,6,-3,17498
2007-08,USA U18,WJC-18,7,0,0,0,0,1,17498
2007-08,Smiths Falls Bears,CJHL,45,14,27,41,60,,19238
2007-08,St. Michael's Buzzers,OPJHL,46,5,18,23,22,,19239
2007-08,HC Vita Hästen,Division 1,40,20,42,62,73,,4613
2008-09,Oshawa Generals,OHL,32,26,28,54,32,5,9223
2008-09,London Knights,OHL,24,32,18,50,22,5,9223
2008-09,Canada U20,WJC-20,6,8,7,15,0,7,9223
2008-09,MODO Hockey J20,SuperElit,2,0,2,2,10,,6007
2008-09,MODO Hockey,SHL,43,7,14,21,52,21,6007
2008-09,Sweden U20,WJC-20,6,0,2,2,6,4,6007
2008-09,Sweden U20 (all),International-Jr,12,3,3,6,16,,6007
2008-09,Sweden,EHT,3,0,0,0,0,-1,6007
2008-09,Sweden (all),International,5,0,0,0,4,-2,6007
2008-09,Brampton Battalion,OHL,57,31,48,79,42,32,12571
2008-09,Canada U18,Hlinka Memorial,4,1,4,5,2,,12571
2008-09,Vancouver Giants,WHL,61,48,48,96,89,51,14657
2008-09,Canada U20,WJC-20,6,2,4,6,2,2,14657
2008-09,Canada U18,Hlinka Memorial,4,1,3,4,6,,14657
2008-09,Brandon Wheat Kings,WHL,70,32,56,88,82,20,14739
2008-09,Canada U18,JWC-18,4,3,4,7,4,,14739
2008-09,Leksands IF,Allsvenskan,39,3,14,17,32,44,7693
2008-09,Sweden U18,WJC-18,6,2,6,8,2,3,7693
2008-09,Sweden U18 (all),International-Jr,16,3,9,12,14,,7693
2008-09,Sweden U20 (all),International-Jr,3,0,0,0,2,,7693
2008-09,London Knights,OHL,56,25,53,78,31,13,14728
2008-09,Brandon Wheat Kings,WHL,55,28,42,70,25,22,13799
2008-09,Spokane Chiefs,WHL,48,7,14,21,45,15,12107
2008-09,Canada U18,Hlinka Memorial,4,0,0,0,6,,12107
2008-09,Timrå IK J20,SuperElit,1,0,0,0,0,,6014
2008-09,Timrå IK,SHL,50,7,10,17,4,-6,6014
2008-09,Sweden U18,WJC-18,6,6,6,12,0,6,6014
2008-09,Sweden U18 (all),International-Jr,12,11,12,23,2,,6014
2008-09,Sweden U20,WJC-20,6,2,5,7,6,6,6014
2008-09,Sweden U20 (all),International-Jr,11,3,9,12,10,,6014
2008-09,Windsor Spitfires,OHL,57,22,67,89,57,52,14012
2008-09,Canada U20,WJC-20,6,1,6,7,0,1,14012
2008-09,Windsor Spitfires,M-Cup,6,3,1,4,4,3,14012
2008-09,Oshawa Generals,OHL,68,8,55,63,40,3,23814
2008-09,Canada U18,WJC-18,6,0,6,6,0,6,23814
2008-09,Peterborough Petes,OHL,61,24,39,63,136,-14,15390
2008-09,Canada U18,WJC-18,6,2,3,5,0,2,15390
2008-09,Canada U18,JWC-18,4,0,2,2,12,,15390
2008-09,Drummondville Voltigeurs,QMJHL,57,12,50,62,46,6,11866
2008-09,Russia U20,WJC-20,7,0,4,4,4,2,11866
2008-09,Drummondville Voltigeurs,M-Cup,4,1,2,3,2,-4,11866
2008-09,Russian Selects,CHL Challenge,1,0,1,1,2,0,11866
2008-09,Guelph Storm,OHL,68,28,39,67,42,10,24654
2008-09,Canada U18,WJC-18,6,1,4,5,8,5,24654
2008-09,OHL All-Stars,CHL Challenge,1,0,0,0,0,,24654
2008-09,Team Southwest,USHS-MN,24,9,11,20,-,,38067
2008-09,Eden Prairie High,USHS-MN,31,12,33,45,26,,38067
2008-09,USA U18,Hlinka Memorial,4,0,2,2,-,,38067
2008-09,Skellefteå AIK J20,SuperElit,10,8,7,15,2,,7069
2008-09,Skellefteå AIK,SHL,45,0,10,10,8,3,7069
2008-09,Sweden U19 (all),International-Jr,4,1,1,2,2,,7069
2008-09,Sweden U20,WJC-20,6,1,1,2,0,3,7069
2008-09,Sweden U20 (all),International-Jr,15,4,2,6,10,,7069
2008-09,Omaha Lancers,USHL,60,28,31,59,78,7,31615
2008-09,Phillips Andover,USHS-Prep,26,33,23,56,10,,37998
2008-09,Valley Jr. Warriors,EJHL,5,4,2,6,-,,37998
2008-09,Djurgårdens IF J18,J18 Allsvenskan,0,0,0,0,0,,7655
2008-09,Djurgårdens IF J20,SuperElit,5,1,2,3,8,,7655
2008-09,Djurgårdens IF,SHL,50,5,11,16,14,-3,7655
2008-09,Sweden U18,WJC-18,6,3,4,7,2,5,7655
2008-09,Sweden U18 (all),International-Jr,16,6,11,17,8,,7655
2008-09,Sweden U20,WJC-20,6,0,0,0,2,-1,7655
2008-09,Sweden U20 (all),International-Jr,13,1,6,7,2,,7655
2008-09,Chicago Steel,USHL,57,14,25,39,50,-7,30901
2008-09,USA U19,WJAC-19,5,0,2,2,0,,30901
2008-09,Univ. of Minnesota,NCAA,35,13,32,45,29,17,11466
2008-09,USA U20,WJC-20,6,3,8,11,2,1,11466
2008-09,Skellefteå AIK J18,J18 Elit,1,0,2,2,10,,6051
2008-09,Skellefteå AIK J18,J18 Allsvenskan,0,0,0,0,0,,6051
2008-09,Skellefteå AIK J20,SuperElit,9,2,12,14,10,,6051
2008-09,Skellefteå AIK,SHL,45,2,5,7,12,5,6051
2008-09,Malmö Redhawks,Allsvenskan,3,0,2,2,0,1,6051
2008-09,Sweden U18,WJC-18,6,3,6,9,12,3,6051
2008-09,Sweden U18 (all),International-Jr,12,4,10,14,20,,6051
2008-09,Sweden U20,WJC-20,5,0,0,0,0,2,6051
2008-09,Sweden U20 (all),International-Jr,10,0,2,2,10,,6051
2008-09,Färjestad BK J18,J18 Allsvenskan,2,2,0,2,0,,6225
2008-09,Färjestad BK,SHL,45,5,5,10,10,4,6225
2008-09,Skåre BK,Division 1,5,5,5,10,0,,6225
2008-09,Sweden U20,WJC-20,6,2,0,2,0,5,6225
2008-09,Sweden U20 (all),International-Jr,15,4,3,7,2,,6225
2008-09,Rimouski Océanic,QMJHL,56,36,31,67,66,14,32870
2008-09,Rimouski Océanic,M-Cup,4,2,0,2,4,-2,32870
2008-09,U.S. National U18 Team,NAHL,5,1,1,2,2,,17508
2008-09,U.S. National U18 Team,USDP,28,14,14,28,49,,17508
2008-09,Shawinigan Cataractes,QMJHL,66,19,31,50,74,20,23204
2008-09,Camrose Kodiaks,AJHL,53,10,19,29,123,,19294
2008-09,Canada U18,WJC-18,6,2,2,4,14,4,19294
2008-09,Canada West U19,WJAC-19,4,1,4,5,18,,19294
2008-09,Lethbridge Hurricanes,WHL,70,30,20,50,93,-5,21033
2008-09,Canada U18,Hlinka Memorial,4,1,2,3,0,,21033
2008-09,Saint John Sea Dogs,QMJHL,66,2,30,32,74,16,30902
2008-09,Canada U18,WJC-18,6,0,2,2,8,5,30902
2008-09,Canada U18,JWC-18,4,2,0,2,8,,30902
2008-09,QMJHL All-Stars,CHL Challenge,2,0,0,0,0,,30902
2008-09,Red Deer Rebels,WHL,68,37,18,55,99,-23,13934
2008-09,Canada U18,WJC-18,5,2,2,4,2,4,13934
2008-09,Erie Otters,OHL,68,16,50,66,26,1,14371
2008-09,Canada U18,WJC-18,6,2,3,5,0,3,14371
2008-09,Canada U18,Hlinka Memorial,4,2,3,5,0,,14371
2008-09,Frölunda HC J18,J18 Elit,2,3,0,3,0,,9791
2008-09,Frölunda HC J18,J18 Allsvenskan,1,1,1,2,0,,9791
2008-09,Frölunda HC J20,SuperElit,35,13,13,26,34,,9791
2008-09,Frölunda HC,SHL,10,2,1,3,0,1,9791
2008-09,Borås HC,Allsvenskan,8,4,2,6,2,1,9791
2008-09,Sweden U18,WJC-18,6,2,2,4,0,3,9791
2008-09,Sweden U18 (all),International-Jr,20,7,11,18,18,,9791
2008-09,Sweden U20 (all),International-Jr,4,1,1,2,2,,9791
2008-09,Barrie Colts,OHL,60,16,12,28,133,1,15480
2008-09,Canada U18,WJC-18,6,0,0,0,16,0,15480
2008-09,U.S. National U18 Team,USDP,47,14,16,30,83,,31273
2008-09,U.S. National U18 Team,NAHL,15,6,2,8,37,3,31273
2008-09,USA U18,WJC-18,7,4,3,7,8,6,31273
2008-09,Brampton Battalion,OHL,63,3,20,23,91,21,31560
2008-09,Des Moines Buccaneers,USHL,56,17,33,50,101,-9,32978
2008-09,Brynäs IF J20,SuperElit,30,14,24,38,6,,6562
2008-09,Brynäs IF,SHL,16,3,1,4,2,-1,6562
2008-09,Sweden U19 (all),International-Jr,8,3,2,5,6,,6562
2008-09,Sweden U20 (all),International-Jr,4,2,2,4,2,,6562
2008-09,Timrå IK J20,SuperElit,8,5,1,6,8,,6016
2008-09,Timrå IK,SHL,47,4,6,10,12,-1,6016
2008-09,Sweden U18,WJC-18,6,2,7,9,16,4,6016
2008-09,Sweden U18 (all),International-Jr,20,6,12,18,38,,6016
2008-09,Sweden U20 (all),International-Jr,4,2,0,2,0,,6016
2008-09,Team Southwest,USHS-MN,15,14,13,27,12,,38068
2008-09,Shawinigan Cataractes,QMJHL,68,11,33,44,77,31,23467
2008-09,U.S. National U18 Team,USDP,47,5,7,12,46,,31272
2008-09,U.S. National U18 Team,NAHL,13,1,4,5,37,5,31272
2008-09,USA U18,WJC-18,7,3,0,3,0,5,31272
2008-09,U.S. National U18 Team,USDP,47,10,25,35,30,,31263
2008-09,U.S. National U18 Team,NAHL,15,7,7,14,16,5,31263
2008-09,USA U18,WJC-18,7,2,7,9,6,5,31263
2008-09,USNTDP Juniors,NAHL,14,12,15,27,28,,17507
2008-09,U.S. National U18 Team,USDP,41,21,11,32,79,,17507
2008-09,USA U18,WJC-18,7,6,4,10,8,6,17507
2008-09,Kingston Frontenacs,OHL,66,32,32,64,83,-5,21591
2008-09,Canada U18,WJC-18,6,4,2,6,6,4,21591
2008-09,Portland Winter Hawks,WHL,72,1,17,18,117,-19,32783
2008-09,Saskatoon Blades,WHL,71,16,39,55,26,20,15735
2008-09,Canada U18,WJC-18,6,0,2,2,0,5,15735
2008-09,Canada U18,Hilinka Memorial,4,0,2,2,0,,15735
2008-09,U.S. National U18 Team,USDP,46,23,13,36,38,,31278
2008-09,U.S. National U18 Team,NAHL,16,4,9,13,12,8,31278
2008-09,USA U18,WJC-18,7,4,1,5,6,2,31278
2008-09,New Hampshire Jr. Monarchs,EJHL,41,7,23,30,30,,33896
2008-09,HC Trinec U20,Czech U20,16,10,9,19,36,5,11849
2008-09,HC Trinec,Czech,15,1,1,2,4,-4,11849
2008-09,HC Havirov,Czech2,3,2,1,3,0,-1,11849
2008-09,Slovakia U20,WJC-20,7,2,3,5,4,-1,11849
2008-09,Brynäs IF J20,SuperElit,37,29,26,55,34,,7084
2008-09,IK Oskarshamn,Allsvenskan,6,0,0,0,2,-1,7084
2008-09,Sweden U19 (all),International-Jr,8,5,8,13,6,,7084
2008-09,Lewiston MAINEiacs,QMJHL,67,10,29,39,80,-9,37536
2008-09,Metallurg Novokuznetsk,KHL,15,1,0,1,4,1,17758
2008-09,Metallurg Novokuznetsk-2,Russia3,4,0,1,1,2,,17758
2008-09,Russia U18,WJC-18,7,2,2,4,6,7,17758
2008-09,Russia U18,Hlinka Memorial,4,1,0,1,6,3,17758
2008-09,Russia U19,WJAC-19,4,0,0,0,2,,17758
2008-09,U.S. National U18 Team,USDP,47,16,16,32,40,,31276
2008-09,U.S. National U18 Team,NAHL,16,8,7,15,14,11,31276
2008-09,USA U18,WJC-18,7,5,5,10,6,9,31276
2008-09,Kingston Frontenacs,OHL,68,2,18,20,140,-14,32723
2008-09,Canada U18,WJC-18,6,0,0,0,8,4,32723
2008-09,Canada U18,JWC-18,4,0,1,1,4,,32723
2008-09,Windsor Spitfires,OHL,67,4,17,21,54,46,33754
2008-09,Windsor Spitfires,M-Cup,5,0,0,0,7,0,33754
2008-09,Streetsville Derbys,OJHL,18,21,28,49,24,,33898
2008-09,Georgetown Raiders,OJHL,26,25,20,45,22,,33898
2008-09,Canada East U19,WJAC-19,4,4,3,7,0,,33898
2008-09,HKM Zvolen,Slovakia,48,7,8,15,20,6,17750
2008-09,HK Detva,Slovakia2,1,1,1,2,2,-1,17750
2008-09,Slovakia U20,WJC-20,7,7,4,11,4,-2,17750
2008-09,Slovakia (all),International,6,1,3,4,-,,17750
2008-09,Chicago Steel,USHL,54,0,22,22,60,-1,10809
2008-09,U.S. National U18 Team,USDP,13,0,4,4,12,,10809
2008-09,USA U18,WJC-18,7,0,3,3,4,9,10809
2008-09,Sweden U18 (all),International-Jr,4,0,0,0,0,,10809
2008-09,Team North,USHS-MN,19,14,8,22,-,,38066
2008-09,Little Falls High,USHS-MN,31,73,62,135,16,,38066
2008-09,Kelowna Rockets,WHL,68,12,40,52,31,17,15127
2008-09,Kelowna Rockets,M-Cup,4,0,4,4,2,-2,15127
2008-09,Blues U20,Jr. A SM-liiga,30,9,29,38,6,20,16043
2008-09,Blues,Liiga,14,0,0,0,4,-3,16043
2008-09,Suomi U20,Mestis,5,2,2,4,0,2,16043
2008-09,Finland U18,WJC-18,6,1,3,4,6,-3,16043
2008-09,Finland U18 (all),International-Jr,12,1,6,7,8,,16043
2008-09,Finland U20,WJC-20,6,1,2,3,0,0,16043
2008-09,Blues,Champions HL,5,1,1,2,0,3,16043
2008-09,Kootenay Ice,WHL,67,10,26,36,140,-4,31079
2008-09,Canada U18,WJC-18,6,0,0,0,2,4,31079
2008-09,Canada U18,JWC-18,4,0,0,0,2,,31079
2008-09,Fargo Force,USHL,55,21,15,36,52,-3,33894
2008-09,USA U19,WJAC-19,5,3,1,4,2,,33894
2008-09,Plymouth Whalers,OHL,64,5,12,17,92,-3,37707
2008-09,St. Michael's Buzzers,OJHL,49,27,48,75,44,,33903
2008-09,Canada East U19,WJAC-19,4,3,1,4,0,,33903
2008-09,Guelph Storm,OHL,67,22,36,58,36,3,24653
2008-09,Minnetonka High,USHS-MN,-,-,-,-,-,,40880
2008-09,Ottawa 67's,OHL,23,8,13,21,32,-4,14436
2008-09,Guelph Storm,OHL,42,14,22,36,60,-6,14436
2008-09,Djurgårdens IF J20,SuperElit,16,5,6,11,45,,7045
2008-09,Djurgårdens IF,SHL,28,0,0,0,2,-6,7045
2008-09,Sweden U19 (all),International-Jr,8,1,0,1,22,,7045
2008-09,Chilliwack Bruins,WHL,61,31,13,44,12,-24,30438
2008-09,Victoriaville Tigres,QMJHL,66,22,35,57,67,-2,19353
2008-09,Czech Republic U18,WJC-18,6,2,2,4,6,0,19353
2008-09,Czech Republic U18 (all),International-Jr,6,2,2,4,6,,19353
2008-09,Lada Togliatti,KHL,47,8,5,13,22,1,11856
2008-09,Lada Togliatti-2,Russia3,7,5,2,7,6,,11856
2008-09,Russia U20,WJC-20,7,3,5,8,2,2,11856
2008-09,Hotchkiss School,USHS-Prep,15,4,11,15,-,,37894
2008-09,Neponset Valley River Rats U18,MHSL U18,16,5,19,24,-,,37894
2008-09,U.S. National U18 Team,USDP,43,14,24,38,48,,17500
2008-09,U.S. National U18 Team,NAHL,14,7,9,16,10,9,17500
2008-09,USA U18,WJC-18,7,1,6,7,12,4,17500
2008-09,Everett Silvertips,WHL,48,1,3,4,103,-17,31082
2008-09,Western Michigan Univ.,NCAA,40,7,11,18,44,-1,38032
2008-09,Rouyn-Noranda Huskies,QMJHL,68,11,19,30,80,3,37437
2008-09,Swift Current Broncos,WHL,54,24,24,48,42,18,23166
2008-09,Canada U18,WJC-18,6,2,0,2,2,0,23166
2008-09,Canada U18,JWC-18,4,2,1,3,0,,23166
2008-09,Prince Albert Raiders,WHL,70,5,32,37,43,-15,32780
2008-09,Brynäs IF J18,J18 Allsvenskan,3,1,1,2,48,,11173
2008-09,Brynäs IF J18,J18 Elit,2,1,2,3,2,,11173
2008-09,Brynäs IF J20,SuperElit,30,9,22,31,54,,11173
2008-09,Brynäs IF,SHL,21,0,1,1,2,-2,11173
2008-09,Sweden U18,WJC-18,6,0,1,1,6,5,11173
2008-09,Sweden U18 (all),International-Jr,19,4,6,10,22,,11173
2008-09,Skellefteå AIK J18,J18 Allsvenskan,2,0,0,0,6,,6021
2008-09,Skellefteå AIK J20,SuperElit,31,8,5,13,46,,6021
2008-09,Skellefteå AIK,SHL,7,1,0,1,0,-1,6021
2008-09,Sweden U18,WJC-18,6,0,0,0,4,-4,6021
2008-09,Sweden U18 (all),International-Jr,22,4,3,7,20,,6021
2008-09,Totino-Grace High,USHS-MN,24,30,22,52,14,,38048
2008-09,Rimouski Océanic,QMJHL,66,3,25,28,64,-6,13583
2008-09,Rimouski Océanic,M-Cup,4,0,0,0,2,-1,13583
2008-09,Mississauga St. Michael's Majors,OHL,55,16,20,36,39,-15,14960
2008-09,Barrie Colts,OHL,63,34,34,68,60,27,15380
2008-09,Moncton Wildcats,QMJHL,68,9,35,44,33,29,32878
2008-09,Medicine Hat Tigers,WHL,71,24,48,72,20,-2,28422
2008-09,Saginaw Spirit,OHL,67,17,34,51,76,17,23107
2008-09,Waterloo Black Hawks,USHL,54,28,48,76,108,32,27038
2008-09,USA U19,WJAC-19,5,3,5,8,2,,27038
2008-09,Vernon Vipers,BCHL,58,8,25,33,126,,38020
2008-09,Vernon Vipers,Doyle Cup,4,0,2,2,6,,38020
2008-09,Miami Univ. (Ohio),NCAA,39,0,26,26,56,11,38081
2008-09,Ilves U20,Jr. A SM-liiga,31,14,17,31,18,15,16035
2008-09,Ilves,Liiga,21,2,3,5,0,0,16035
2008-09,Suomi U20,Mestis,4,1,2,3,2,2,16035
2008-09,Finland U18,WJC-18,6,10,9,19,6,10,16035
2008-09,Finland U18 (all),International-Jr,21,18,22,40,10,,16035
2008-09,Finland U20,WJC-20,6,2,1,3,4,0,16035
2008-09,Mora IK J20,SuperElit,21,3,5,8,32,,8373
2008-09,Mora IK,Allsvenskan,38,2,11,13,12,7,8373
2008-09,Sweden U19 (all),International-Jr,8,1,2,3,6,,8373
2008-09,Canmore Eagles,AJHL,32,18,23,41,84,,32805
2008-09,Kootenay Ice,WHL,4,0,1,1,4,0,32805
2008-09,Calgary Hitmen,WHL,22,9,7,16,12,5,32805
2008-09,Sudbury Wolves,OHL,65,12,18,30,96,-21,18601
2008-09,Red Deer Rebels,WHL,32,0,4,4,30,-6,24531
2008-09,JYP U18,Jr. B SM-sarja Q,3,1,1,2,14,,16044
2008-09,JYP U18,Jr. B I-divisioona,2,2,3,5,0,,16044
2008-09,JYP U20,Jr. A SM-liiga,20,3,7,10,22,-8,16044
2008-09,D Team,Mestis,5,1,1,2,8,-2,16044
2008-09,Suomi U20,Mestis,2,0,0,0,2,0,16044
2008-09,Finland U18,WJC-18,6,1,1,2,2,6,16044
2008-09,Finland U18 (all),International-Jr,22,5,12,17,48,,16044
2008-09,Owen Sound Attack,OHL,53,17,18,35,44,-7,23809
2008-09,Kamloops Blazers,WHL,68,30,39,69,82,-4,18880
2008-09,Dynamo Moskva-2,Russia3,29,20,26,46,52,,38656
2008-09,Roseau High,USHS-MN,8,4,10,14,6,,37916
2008-09,Fargo Force,USHL,12,1,1,2,11,-3,37916
2008-09,Färjestad BK,SHL,10,0,0,0,0,-1,7101
2008-09,Skåre BK J20,J20 Elit,1,2,0,2,4,,7101
2008-09,Skåre BK,Division 1,38,21,14,35,83,,7101
2008-09,Sweden U19 (all),International-Jr,8,0,2,2,4,,7101
2008-09,Owen Sound Attack,OHL,26,8,6,14,85,-1,23003
2008-09,Windsor Spitfires,OHL,38,7,14,21,112,23,23003
2008-09,Windsor Spitfires,M-Cup,6,0,1,1,6,0,23003
2008-09,Nepean Raiders,CJHL,55,12,29,41,50,,38058
2008-09,Canada East U19,WJAC-19,4,0,1,1,2,,38058
2008-09,Sioux City Musketeers,USHL,58,4,12,16,64,-10,33895
2008-09,USA U19,WJAC-19,5,0,0,0,8,,33895
2008-09,Waterloo Black Hawks,USHL,58,7,27,34,75,22,31602
2008-09,Shattuck St. Mary's Midget Prep,USHS-Prep,52,40,47,87,52,,7054
2008-09,Everett Silvertips,WHL,72,19,38,57,30,-13,31081
2008-09,Canada U18,WJC-18,6,4,3,7,4,6,31081
2008-09,Guelph Storm,OHL,67,2,10,12,111,11,33875
2008-09,Shawinigan Cataractes,QMJHL,68,37,53,90,42,56,23202
2008-09,Lokomotiv Yaroslavl,KHL,1,0,0,0,0,0,17575
2008-09,Lokomotiv Yaroslavl-2,Russia3,68,5,13,18,68,,17575
2008-09,Delbarton School,USHS-Prep,30,16,35,51,42,,38064
2008-09,Saginaw Spirit,OHL,66,1,6,7,128,4,23108
2008-09,Owen Sound Attack,OHL,63,18,28,46,52,-5,14642
2008-09,Providence Bruins,AHL,4,0,0,0,0,4,14642
2008-09,HC Ceské Budejovice U20,Czech U20,31,16,17,33,14,13,18089
2008-09,HC Ceske Budejovice,Czech,8,0,0,0,0,-1,18089
2008-09,Czech Republic U18,WJC-18,6,2,1,3,4,-5,18089
2008-09,Czech Republic U18 (all),International-Jr,18,6,8,14,22,,18089
2008-09,HC Ceske Budejovice,Champions HL,1,1,0,1,0,,18089
2008-09,Philadelphia Jr. Flyers 18U,AYHL 18U,51,13,32,45,30,,38031
2008-09,Edmonton Oil Kings,WHL,49,17,19,36,23,2,12565
2008-09,Czech Republic U20,WJC-20,6,0,3,3,2,2,12565
2008-09,Czech Republic U20 (all),International-Jr,12,2,5,7,14,,12565
2008-09,Drummondville Voltigeurs,QMJHL,62,52,42,94,86,25,18800
2008-09,Drummondville Voltigeurs,M-Cup,4,0,1,1,4,-3,18800
2008-09,Guelph Storm,OHL,67,33,40,73,95,1,30030
2008-09,Syracuse Crunch,AHL,4,1,0,1,2,0,30030
2008-09,Baie-Comeau Drakkar,QMJHL,60,22,39,61,82,-4,28421
2008-09,Malden Catholic High,USHS-Prep,23,6,23,29,-,,40881
2008-09,Boston Jr. Bruins,EJHL,32,5,10,15,18,,40881
2008-09,Okotoks Oilers,AJHL,61,34,38,72,55,,38063
2008-09,Tri-City Storm,USHL,47,21,12,33,37,-23,27025
2008-09,Phillips Exeter Academy,USHS-Prep,35,14,38,52,30,,38061
2008-09,Boston Little Bruins,Midget,18,1,1,2,10,,38061
2008-09,South Kent Prep.,USHS-Prep,32,27,36,63,18,,38054
2008-09,Drummondville Voltigeurs,QMJHL,51,28,21,49,63,28,36736
2008-09,Drummondville Voltigeurs,M-Cup,4,2,0,2,4,-2,36736
2008-09,Surrey Eagles,BCHL,60,20,21,41,32,,38046
2008-09,Frölunda HC J18,J18 Elit,1,0,0,0,0,,10071
2008-09,Frölunda HC J18,J18 Allsvenskan,4,0,1,1,4,,10071
2008-09,Frölunda HC J20,SuperElit,36,3,5,8,42,,10071
2008-09,Sweden U18,WJC-18,6,1,0,1,6,2,10071
2008-09,Sweden U18 (all),International-Jr,22,3,2,5,22,,10071
2008-09,Okotoks Oilers,AJHL,41,17,12,29,69,,40882
2008-09,Mississauga St. Michael's Majors,OHL,64,3,25,28,89,21,15383
2008-09,Cedar Rapids Roughriders,USHL,54,24,9,33,73,8,33899
2008-09,London Knights,OHL,58,19,33,52,32,13,15485
2008-09,Djurgårdens IF J20,SuperElit,34,9,30,39,24,,8311
2008-09,Djurgårdens IF,SHL,15,2,2,4,2,3,8311
2008-09,Sweden U19 (all),International-Jr,6,2,3,5,2,,8311
2008-09,Green Bay Gamblers,USHL,52,5,17,22,27,34,37773
2008-09,Belleville Bulls,OHL,44,4,12,16,10,6,33614
2008-09,Edina High,USHS-MN,25,20,46,66,22,,19068
2008-09,Team Southwest,USHS-MN,18,12,17,29,-,,19068
2008-09,Shawinigan Cataractes,QMJHL,59,13,48,61,76,23,23201
2008-09,Kamloops Blazers,WHL,72,25,32,57,41,-3,23159
2008-09,Mississauga St. Michael's Majors,OHL,68,19,46,65,121,7,15707
2008-09,Kelowna Rockets,WHL,71,12,9,21,77,-4,30440
2008-09,Kelowna Rockets,M-Cup,4,0,0,0,0,-1,30440
2008-09,U.S. National U18 Team,USDP,42,15,27,42,57,,31274
2008-09,U.S. National U18 Team,NAHL,11,8,6,14,4,10,31274
2008-09,USA U18,WJC-18,7,4,9,13,8,5,31274
2008-09,Penticton Vees,BCHL,53,30,34,64,90,,19277
2008-09,Canada West U19,WJAC-19,4,1,0,1,6,,19277
2008-09,Ottawa 67's,OHL,68,34,26,60,48,21,23812
2008-09,Blues U20,Jr. A SM-liiga,9,1,2,3,31,2,15136
2008-09,Kitchener Rangers,OHL,38,25,24,49,28,0,18618
2008-09,Windsor Spitfires,OHL,28,10,14,24,33,6,18618
2008-09,Windsor Spitfires,M-Cup,6,1,2,3,8,-2,18618
2008-09,London Nationals,GOJHL,22,6,10,16,48,,30688
2008-09,London Knights,OHL,17,0,0,0,20,6,30688
2008-09,Oshawa Generals,OHL,26,1,8,9,51,-12,30688
2008-09,Malmö Redhawks J20,SuperElit,31,2,14,16,73,3,7234
2008-09,Malmö Redhawks,Allsvenskan,13,0,3,3,8,-2,7234
2008-09,Sweden U19 (all),International-Jr,4,0,1,1,6,,7234
2008-09,Erie Otters,OHL,61,1,16,17,28,24,37634
2008-09,Trenton Hercs,OJHL,32,22,20,42,20,,38042
2008-09,Kingston Voyageurs,OJHL,12,10,11,21,8,,38042
2008-09,Kingston Voyageurs,Dudley Hewitt Cup,4,1,3,4,2,,38042
2008-09,Kingston Voyageurs,RBC Cup,5,3,1,4,6,,38042
2008-09,Sudbury Wolves,OHL,44,2,14,16,60,-8,37729
2008-09,Windsor Spitfires,OHL,61,16,18,34,12,27,23008
2008-09,Windsor Spitfires,M-Cup,6,1,3,4,2,1,23008
2008-09,Shawinigan Cataractes,QMJHL,53,3,1,4,111,0,18872
2008-09,Regina Pats,WHL,71,10,5,15,140,-15,21032
2008-09,Canada U18,WJC-18,6,0,1,1,6,0,21032
2008-09,Belleville Bulls,OHL,36,10,5,15,60,2,31565
2008-09,Kitchener Rangers,OHL,37,14,8,22,39,-14,31565
2008-09,Cumberland Grads,CJHL,58,22,38,60,78,,38052
2008-09,Canada East U19,WJAC-19,4,1,2,3,4,,38052
2008-09,KalPa U20,Jr. A SM-liiga,29,1,8,9,56,-2,17287
2008-09,Finland U18,WJC-18,6,0,0,0,10,-1,17287
2008-09,Finland U18 (all),International-Jr,18,2,1,3,52,,17287
2008-09,Calgary Hitmen,WHL,72,40,68,108,58,50,23151
2008-09,Kelowna Rockets,WHL,70,14,13,27,188,11,36708
2008-09,Kelowna Rockets,M-Cup,4,0,1,1,2,1,36708
2008-09,Linköping HC J20,SuperElit,0,0,0,0,0,,4996
2008-09,Linköping HC,SHL,14,0,1,1,6,-6,4996
2008-09,IK Oskarshamn,Allsvenskan,29,2,4,6,22,-7,4996
2008-09,Sweden U20,WJC-20,6,0,2,2,2,4,4996
2008-09,Sweden U20 (all),International-Jr,15,1,5,6,10,,4996
2008-09,Shattuck St. Mary's Midget Prep,USHS-Prep,53,26,58,84,46,,16042
2008-09,Finland U18,WJC-18,6,3,1,4,2,-6,16042
2008-09,Finland U18 (all),International-Jr,15,6,8,14,8,,16042
2008-09,Shattuck St. Mary's Midget Prep,USHS-Prep,54,7,25,32,70,,17654
2008-09,Belarus U18,WJC-18 D1,4,1,1,2,2,3,17654
2008-09,Nobles Prep,USHS-Prep,29,5,29,34,16,,38049
2008-09,Spokane Chiefs,WHL,71,23,36,59,57,31,18603
2008-09,Sault Ste. Marie Greyhounds,OHL,64,16,27,43,158,-17,23805
2008-09,Saint John Sea Dogs,QMJHL,67,19,29,48,47,-19,33846
2008-09,London Knights,OHL,14,0,0,0,21,-2,31574
2008-09,Peterborough Petes,OHL,20,0,2,2,36,-7,31574
2008-09,Prince George Cougars,WHL,59,16,24,40,34,-13,17752
2008-09,Slovakia U20,WJC-20,7,0,4,4,4,-4,17752
2008-09,Avon Old Farms School,USHS-Prep,-,-,-,-,-,,40883
2008-09,Lincoln Stars,USHL,51,3,7,10,162,0,33912
2008-09,Victoria Grizzlies,BCHL,41,6,17,23,32,,40884
2008-09,Westside Warriors,BCHL,17,6,11,17,10,,40884
2008-09,Dallas Stars  U18,T1EHL U18,46,16,38,54,38,,40885
2008-09,Shawinigan Cataractes,QMJHL,63,28,16,44,66,22,36718
2008-09,Cedar Rapids Roughriders,USHL,60,8,25,33,56,7,37788
2008-09,St. Cloud State Univ.,NCAA,28,0,1,1,38,-5,6660
2008-09,Denmark U20,WJC-20 D1,5,0,0,0,6,-4,6660
2008-09,Mississauga St. Michael's Majors,OHL,59,9,3,12,135,1,23046
2008-09,St. Louis Bandits,NAHL,3,0,0,0,2,-1,39372
2008-09,Wenatchee Wild,NAHL,43,16,33,49,71,9,39372
2008-09,Tri-City Storm,USHL,26,10,19,29,11,-17,16691
2008-09,Indiana Ice,USHL,30,24,23,47,12,2,16691
2008-09,USA U19,WJAC-19,5,5,5,10,2,,16691
2008-09,Mechel Chelyabinsk,Russia2,35,2,4,6,40,7,29170
2008-09,Mechel Chelyabinsk-2,Russia3,3,0,1,1,4,,29170
2008-09,Russia U20,WJC-20,7,0,2,2,2,6,29170
2008-09,Russian Selects,CHL Challenge,6,1,0,1,22,-1,29170
2008-09,Saskatoon Blades,WHL,71,22,35,57,41,31,32769
2008-09,Duluth East High,USHS-MN,25,28,20,48,20,,38044
2008-09,Waterloo Black Hawks,USHL,59,32,22,54,59,17,19154
2008-09,Merritt Centennials,BCHL,30,2,10,12,16,,38056
2008-09,Cowichan Valley Capitals,BCHL,16,2,4,6,2,,38056
2008-09,Prince Edward Island Rocket,QMJHL,68,39,41,80,49,32,32873
2008-09,Nepean Raiders,CJHL,38,14,21,35,54,,33901
2008-09,Canada East U19,WJAC-19,4,1,0,1,6,,33901
2008-09,Eisbären Berlin,DEL,7,0,1,1,2,2,17622
2008-09,Eisbären Juniors Berlin,Germany3,47,14,25,39,104,,17622
2008-09,Germany U20,WJC-20,6,0,0,0,4,-4,17622
2008-09,Eisbären Berlin,Champions HL,1,0,0,0,0,0,17622
2008-09,Red Deer Rebels,WHL,65,1,21,22,49,-9,16045
2008-09,Finland U18,WJC-18,6,0,3,3,22,3,16045
2008-09,Finland U18 (all),International-Jr,12,3,4,7,40,,16045
2008-09,Finland U20,WJC-20,6,1,0,1,6,0,16045
2008-09,Québec Remparts,QMJHL,67,11,32,43,24,14,37467
2008-09,HV71 J20,SuperElit,41,8,28,36,44,,10378
2008-09,Sweden U18 (all),International-Jr,14,1,3,4,10,,10378
2009-10,Windsor Spitfires,OHL,57,40,66,106,56,46,14360
2009-10,Canada U20,WJC-20,6,6,6,12,0,3,14360
2009-10,Windsor Spitfires,M-Cup,4,5,4,9,2,8,14360
2009-10,Plymouth Whalers,OHL,63,48,58,106,54,17,23807
2009-10,Canada U18,JWC-18,4,4,6,10,6,,23807
2009-10,Kingston Frontenacs,OHL,41,2,21,23,68,11,31282
2009-10,Canada U18,WJC-18,6,0,1,1,4,2,31282
2009-10,Portland Winterhawks,WHL,71,25,44,69,53,17,45512
2009-10,Portland Winterhawks,WHL,65,36,24,60,68,11,17679
2009-10,Switzerland U18 (all),International-Jr,7,3,7,10,8,,17679
2009-10,Switzerland U20,WJC-20,7,6,4,10,10,-2,17679
2009-10,Switzerland U20 (all),International-Jr,13,11,6,17,14,,17679
2009-10,Switzerland,WC,4,0,0,0,4,0,17679
2009-10,Switzerland (all),International,7,0,0,0,4,,17679
2009-10,Prince George Cougars,WHL,16,10,9,19,8,-3,23297
2009-10,Canada U18,WJC-18,4,1,0,1,10,0,23297
2009-10,Canada U18,Hlinka Memorial,2,0,1,1,0,,23297
2009-10,Kitchener Rangers,OHL,64,50,40,90,72,7,23668
2009-10,Canada U18,Hlinka Memorial,4,6,0,6,16,,23668
2009-10,Barrie Colts,OHL,62,22,43,65,49,32,22927
2009-10,Russia U20,WJC-20,6,3,1,4,6,2,22927
2009-10,Russian Selects,Jr Super Series,2,0,2,2,4,-1,22927
2009-10,HIFK,Liiga,43,13,27,40,2,11,16037
2009-10,Suomi U20,Mestis,1,0,0,0,0,0,16037
2009-10,Finland U18,WJC-18,6,4,9,13,4,0,16037
2009-10,Finland U18 (all),International-Jr,2,0,0,0,4,,16037
2009-10,Finland U20,WJC-20,6,1,6,7,4,-4,16037
2009-10,Finland U20 (all),International-Jr,10,2,8,10,6,,16037
2009-10,Finland,EHT,3,1,1,2,0,-1,16037
2009-10,Moose Jaw Warriors,WHL,65,7,17,24,169,20,37170
2009-10,Windsor Spitfires,OHL,55,8,47,55,14,38,31261
2009-10,USA U20,WJC-20,7,0,2,2,4,8,31261
2009-10,Windsor Spitfires,M-Cup,4,2,4,6,0,8,31261
2009-10,Moncton Wildcats,QMJHL,58,9,34,43,54,31,19428
2009-10,Moncton Wildcats,M-Cup,3,1,2,3,0,-1,19428
2009-10,QMJHL All-Stars,CHL Challenge,2,0,0,0,0,0,19428
2009-10,Tri-City Storm,USHL,60,33,50,83,18,-6,33907
2009-10,Canada U18,Hlinka Memorial,4,2,2,4,0,,33907
2009-10,USNTDP Juniors,USHL,26,4,10,14,26,12,31265
2009-10,U.S. National U18 Team,USDP,65,5,23,28,46,,31265
2009-10,USA U18,WJC-18,7,0,2,2,6,9,31265
2009-10,Sibir Novosibirsk,KHL,42,13,11,24,18,9,24787
2009-10,Sibirskie Snaipery Novosibirsk,MHL,1,1,0,1,0,1,24787
2009-10,Russia U20,WJC-20,6,4,1,5,2,-1,24787
2009-10,Russia,EHT,3,0,0,0,0,-1,24787
2009-10,Russia (all),International,3,0,0,0,0,0,24787
2009-10,Owen Sound Attack,OHL,36,16,24,40,26,10,15388
2009-10,Windsor Spitfires,OHL,42,11,23,34,14,11,33753
2009-10,Peterborough Petes,OHL,10,9,11,20,8,5,33753
2009-10,U.S. National U18 Team,USDP,9,4,2,6,33,,33753
2009-10,USA U18,WJC-18,7,2,1,3,33,2,33753
2009-10,Team Northwest,USHS-MN,23,13,8,21,18,,40265
2009-10,Blaine High,USHS-MN,25,29,31,60,24,,40265
2009-10,U.S. National U18 Team,USDP,4,0,0,0,0,,40265
2009-10,Blaine High,MN State,2,0,0,0,0,,40265
2009-10,Penticton Vees,BCHL,56,41,79,120,20,,46980
2009-10,USA U19,WJAC-19,5,3,1,4,0,,46980
2009-10,Univ. of Notre Dame,NCAA,37,6,11,17,22,-10,33929
2009-10,USNTDP Juniors,USHL,26,4,5,9,68,14,20706
2009-10,U.S. National U18 Team,USDP,39,2,6,8,37,,20706
2009-10,USA U18,WJC-18,7,1,1,2,10,8,20706
2009-10,Edmonton Oil Kings,WHL,48,7,17,24,47,-19,23154
2009-10,Canada U18,Hlinka Memorial,4,0,2,2,2,,23154
2009-10,Noble & Greenough School,USHS-Prep,29,25,44,69,8,,40243
2009-10,Cape Cod Whalers U18,MHSL U18,25,21,30,51,-,,40243
2009-10,U.S. National U18 Team,USDP,2,2,0,2,0,,40243
2009-10,Moose Jaw Warriors,WHL,65,28,37,65,44,14,31281
2009-10,Canada U18,WJC-18,6,4,2,6,4,9,31281
2009-10,Canada U18,Hlinka Memorial,4,0,0,0,2,,31281
2009-10,Traktor Chelyabinsk,KHL,35,2,6,8,10,-6,34777
2009-10,Belye Medvedi Chelyabinsk,MHL,9,4,12,16,8,12,34777
2009-10,Russia U18,WJC-18,7,5,7,12,6,8,34777
2009-10,Russia U20,WJC-20,6,2,0,2,10,1,34777
2009-10,South Shore Kings,EJHL,42,21,42,63,50,,60251
2009-10,U.S. National U18 Team,USDP,4,1,0,1,2,,60251
2009-10,Medicine Hat Tigers,WHL,72,37,28,65,26,8,20718
2009-10,Great Plains,USHS-MN,24,16,16,32,12,,74997
2009-10,Warroad High,USHS-MN,25,39,34,73,38,39,74997
2009-10,Warroad High,MN State,3,6,4,10,2,8,74997
2009-10,Minnesota State Univ. (Mankato),NCAA,38,11,8,19,27,-1,40064
2009-10,London Knights,OHL,63,36,21,57,39,16,23111
2009-10,Sudbury Wolves,OHL,64,20,30,50,70,-17,22106
2009-10,Canada U18,WJC-18,6,4,1,5,8,-3,22106
2009-10,Ottawa 67's,OHL,62,21,23,44,129,20,30923
2009-10,Brynäs IF J18,J18 Elit,3,3,5,8,14,,13161
2009-10,Brynäs IF J18,J18 Allsvenskan,3,2,2,4,2,,13161
2009-10,Brynäs IF J20,SuperElit,39,21,29,50,37,,13161
2009-10,Sweden U18,WJC-18,6,6,6,12,4,7,13161
2009-10,Sweden U18 (all),International-Jr,21,12,18,30,12,,13161
2009-10,Sweden U18/19,WJAC-19,4,0,2,2,4,,13161
2009-10,Red Deer Rebels,WHL,57,8,19,27,87,3,32778
2009-10,USNTDP Juniors,USHL,21,9,3,12,46,6,20715
2009-10,U.S. National U18 Team,USDP,39,12,9,21,20,,20715
2009-10,USA U18,WJC-18,7,1,3,4,6,8,20715
2009-10,USNTDP Juniors,USHL,22,1,8,9,12,3,20712
2009-10,U.S. National U17 Team,USDP,2,0,1,1,2,,20712
2009-10,U.S. National U18 Team,USDP,56,5,27,32,18,,20712
2009-10,USA U18,WJC-18,7,0,1,1,2,3,20712
2009-10,Kelowna Rockets,WHL,65,13,27,40,95,-7,36711
2009-10,Oshawa Generals,OHL,64,41,25,66,27,-10,30686
2009-10,Canada U18,WJC-18,6,2,1,3,6,-1,30686
2009-10,AIK J18,J18 Allsvenskan,3,0,1,1,4,,10383
2009-10,AIK J20,SuperElit,38,1,19,20,120,,10383
2009-10,AIK,Allsvenskan,16,0,3,3,8,7,10383
2009-10,Sweden U18,WJC-18,6,0,2,2,8,7,10383
2009-10,Sweden U18 (all),International-Jr,19,2,6,8,72,,10383
2009-10,Sweden U18/19,WJAC-19,4,0,1,1,6,,10383
2009-10,Mississauga St. Michael's Majors,OHL,60,29,33,62,35,27,32728
2009-10,Portland Winterhawks,WHL,71,27,41,68,203,22,32786
2009-10,Brynäs IF J20,SuperElit,35,30,27,57,55,,9782
2009-10,Brynäs IF,SHL,18,0,0,0,2,-3,9782
2009-10,Sweden U19 (all),International-Jr,7,7,7,14,4,,9782
2009-10,Peterborough Petes,OHL,47,19,35,54,12,-5,23117
2009-10,Canada U18,WJC-18,6,2,0,2,2,-4,23117
2009-10,Canada U18,JWC-18,4,1,0,1,4,,23117
2009-10,HK Orange 20,Slovakia,35,2,4,6,71,-27,34750
2009-10,HC Kosice U20,Slovakia U20,0,0,0,0,0,,34750
2009-10,Slovakia U18,WJC-18,6,2,1,3,14,3,34750
2009-10,Slovakia U20,WJC-20,6,0,2,2,6,-3,34750
2009-10,Ottawa 67's,OHL,65,37,42,79,54,25,23813
2009-10,Canada U18,JWC-18,4,3,5,8,2,,23813
2009-10,Saskatoon Blades,WHL,26,7,9,16,6,9,31288
2009-10,Des Moines Buccaneers,USHL,52,22,21,43,68,-12,45687
2009-10,U.S. National U18 Team,USDP,14,2,5,7,6,,45687
2009-10,USA U18,WJC-18,7,0,4,4,4,5,45687
2009-10,Brynäs IF J20,SuperElit,19,11,20,31,30,,6020
2009-10,Brynäs IF,SHL,33,4,6,10,2,5,6020
2009-10,Sweden U18 (all),International-Jr,4,0,3,3,0,,6020
2009-10,Sweden U19 (all),International-Jr,3,0,2,2,0,,6020
2009-10,Brampton Battalion,OHL,64,18,14,32,52,-10,39491
2009-10,Team Northeast,USHS-MN,24,13,9,22,6,,74998
2009-10,Cretin-Derham Hall,USHS-MN,24,6,14,20,20,,74998
2009-10,Minnetonka High,USHS-MN,25,17,14,31,8,,46905
2009-10,Team Southwest,USHS-MN,22,6,5,11,18,,46905
2009-10,Omaha Lancers,USHL,11,0,4,4,6,7,46905
2009-10,Minnetonka High,MN State,3,1,2,3,0,,46905
2009-10,Rimouski Océanic,QMJHL,62,28,36,64,54,-4,34805
2009-10,Czech Republic U18 (all),International-Jr,4,0,1,1,0,,34805
2009-10,Brynäs IF J18,J18 Elit,1,0,0,0,0,,9009
2009-10,Brynäs IF J18,J18 Allsvenskan,3,1,1,2,2,,9009
2009-10,Brynäs IF J20,SuperElit,40,15,19,34,80,,9009
2009-10,Sweden U18,WJC-18,5,6,8,14,0,8,9009
2009-10,Sweden U18 (all),International-Jr,16,8,14,22,37,,9009
2009-10,Sweden U18/19,WJAC-19,4,0,1,1,6,,9009
2009-10,Skellefteå AIK J20,SuperElit,30,14,23,37,44,,10711
2009-10,Skellefteå AIK,SHL,36,1,1,2,35,-7,10711
2009-10,Sweden U19 (all),International-Jr,7,6,7,13,6,,10711
2009-10,Sweden U20 (all),International-Jr,3,3,1,4,0,,10711
2009-10,USNTDP Juniors,USHL,22,11,7,18,23,6,20726
2009-10,U.S. National U18 Team,USDP,38,18,17,35,24,,20726
2009-10,USA U18,WJC-18,7,4,3,7,2,6,20726
2009-10,USA U20,WJC-20,7,2,0,2,2,0,20726
2009-10,U.S. National U18 Team,USDP,62,3,16,19,67,,20711
2009-10,USNTDP Juniors,USHL,23,1,7,8,29,12,20711
2009-10,USA U18,WJC-18,7,0,3,3,10,2,20711
2009-10,Ottawa 67's,OHL,61,19,41,60,37,2,23810
2009-10,Erie Otters,OHL,67,37,48,85,32,18,31283
2009-10,Canada U18,WJC-18,6,1,6,7,4,2,31283
2009-10,Sault Ste. Marie Greyhounds,OHL,66,7,19,26,64,-9,19612
2009-10,Canada U18,WJC-18,4,0,1,1,2,1,19612
2009-10,Canada U18,JWC-18,4,1,1,2,4,,19612
2009-10,Kootenay Ice,WHL,72,21,30,51,38,12,30443
2009-10,Canada U18,WJC-18,6,0,1,1,39,-2,30443
2009-10,Moncton Wildcats,QMJHL,22,10,13,23,34,4,19427
2009-10,Russia U18,Hlinka Memorial,4,5,2,7,4,-1,19427
2009-10,Everett Silvertips,WHL,65,7,30,37,151,45,18085
2009-10,Czech Republic U20,WJC-20,6,0,2,2,14,2,18085
2009-10,Czech Republic U20 (all),International-Jr,10,3,3,6,16,,18085
2009-10,Harvard Univ.,NCAA,32,5,4,9,47,-2,40194
2009-10,Rouyn-Noranda Huskies,QMJHL,68,20,26,46,16,26,37441
2009-10,Shattuck St. Mary's Midget Prep,USHS-Prep,52,24,22,46,39,,30055
2009-10,Regina Pats,WHL,72,35,67,102,54,3,23324
2009-10,Canada U18,WJC-18,6,3,6,9,30,8,23324
2009-10,Canada U18,Hlinka Memorial,4,1,3,4,4,,23324
2009-10,Shawinigan Cataractes,QMJHL,58,24,38,62,37,1,36719
2009-10,Canada U18,WJC-18,6,2,1,3,2,3,36719
2009-10,QMJHL All-Stars,CHL Challenge,2,0,1,1,0,0,36719
2009-10,Gatineau Olympiques,QMJHL,63,9,26,35,45,14,34749
2009-10,Kootenay Ice,WHL,70,3,23,26,77,33,37152
2009-10,Team Southwest,USHS-MN,23,9,15,24,40,,40259
2009-10,Minnetonka High,USHS-MN,17,17,26,43,14,,40259
2009-10,Minnetonka High,MN State,3,3,2,5,0,,40259
2009-10,Chilliwack Bruins,WHL,72,25,36,61,101,9,31085
2009-10,Rimouski Océanic,QMJHL,63,13,34,47,54,0,34785
2009-10,Czech Republic U18 (all),International-Jr,4,0,1,1,6,,34785
2009-10,Brampton Capitals,OJAHL,10,6,5,11,24,,39485
2009-10,Orangeville Crushers,CCHL,19,13,13,26,26,11,39485
2009-10,Canada East U19,WJAC-19,4,1,1,2,2,,39485
2009-10,Portland Winterhawks,WHL,71,5,25,30,65,13,27126
2009-10,MODO Hockey J18,J18 Elit,8,11,15,26,10,,27945
2009-10,MODO Hockey J18,J18 Allsvenskan,16,10,3,13,12,,27945
2009-10,MODO Hockey J20,SuperElit,32,7,20,27,22,,27945
2009-10,Norway U18,WJC-18 D1,5,7,15,22,4,11,27945
2009-10,Norway U20,WJC-20 D1,5,3,1,4,0,6,27945
2009-10,USNTDP Juniors,USHL,27,10,13,23,6,15,20708
2009-10,U.S. National U17 Team,USDP,1,0,0,0,0,,20708
2009-10,U.S. National U18 Team,USDP,65,26,26,52,24,,20708
2009-10,USA U18,WJC-18,7,4,2,6,4,4,20708
2009-10,Montréal Juniors,QMJHL,66,15,18,33,69,-5,37500
2009-10,Shattuck St. Mary's Midget Prep,USHS-Prep,54,23,23,46,80,,75016
2009-10,Calgary Hitmen,WHL,64,6,33,39,62,16,37110
2009-10,Calgary Hitmen,M-Cup,4,0,0,0,4,0,37110
2009-10,Plymouth Whalers,OHL,68,3,9,12,116,10,33650
2009-10,Saint John Sea Dogs,QMJHL,67,15,45,60,38,41,24635
2009-10,Russia U18 (all),International-Jr,4,1,2,3,4,-2,24635
2009-10,Russia U18,Hlinka Memorial,4,1,2,3,4,-2,24635
2009-10,Newmarket Hurricanes,CCHL,39,7,16,23,16,,73778
2009-10,Team Southeast,USHS-MN,16,4,9,13,12,,67092
2009-10,Woodbury High,USHS-MN,25,19,17,36,36,,67092
2009-10,Sioux City Musketeers,USHL,11,1,1,2,2,-6,67092
2009-10,Lewiston MAINEiacs,QMJHL,68,28,27,55,60,-12,37543
2009-10,AIK J18,J18 Allsvenskan,2,1,1,2,0,,18332
2009-10,AIK J20,SuperElit,28,6,9,15,53,,18332
2009-10,AIK,Allsvenskan,2,0,0,0,0,0,18332
2009-10,Sweden U18,WJC-18,6,0,2,2,6,-2,18332
2009-10,Sweden U18 (all),International-Jr,16,1,6,7,6,,18332
2009-10,Sweden U18/19,WJAC-19,4,1,2,3,0,,18332
2009-10,Acadie-Bathurst Titan,QMJHL,64,4,34,38,72,-22,37074
2009-10,Camrose Kodiaks,AJHL,34,3,19,22,61,,39631
2009-10,Sault Ste. Marie Greyhounds,OHL,68,5,28,33,81,-11,31583
2009-10,Belleville Bulls,OHL,66,4,45,49,61,-27,33613
2009-10,Canada U18,WJC-18,6,0,2,2,0,7,33613
2009-10,Canada U18,JWC-18,4,0,1,1,2,,33613
2009-10,Owen Sound Attack,OHL,62,4,36,40,26,1,45578
2009-10,Canada U18,WJC-18,6,0,1,1,2,3,45578
2009-10,Vancouver Giants,WHL,72,37,60,97,44,6,18886
2009-10,Owen Sound Attack,OHL,68,23,40,63,32,-18,31284
2009-10,Canada U18,WJC-18,6,1,2,3,4,2,31284
2009-10,Kärpät U20,Jr. A SM-liiga,18,14,15,29,2,9,16039
2009-10,Kärpät,Liiga,18,2,2,4,4,-2,16039
2009-10,Suomi U20,Mestis,4,1,0,1,0,-1,16039
2009-10,Finland U18,WJC-18,6,1,7,8,0,-1,16039
2009-10,Finland U18 (all),International-Jr,12,4,11,15,0,,16039
2009-10,Finland U20 (all),International-Jr,3,0,1,1,0,,16039
2009-10,Erie Otters,OHL,63,25,30,55,97,-10,13839
2009-10,Saginaw Spirit,OHL,51,26,18,44,20,2,41028
2009-10,Russia U20,WJC-20,5,0,0,0,2,0,41028
2009-10,Russia U18,Hlinka Memorial,3,0,3,3,0,0,41028
2009-10,Russian Selects,Jr Super Series,1,0,0,0,2,-1,41028
2009-10,Univ. of Wisconsin,NCAA,41,2,10,12,51,16,31270
2009-10,USA U20,WJC-20,7,0,3,3,0,5,31270
2009-10,Kiekko-Vantaa U18,Jr. B SM-sarja Q,12,1,5,6,22,,45342
2009-10,Kiekko-Vantaa U18,Jr. B SM-sarja,23,2,12,14,49,,45342
2009-10,Finland U18,WJC-18,6,1,1,2,6,3,45342
2009-10,Finland U18 (all),International-Jr,2,0,0,0,2,,45342
2009-10,Windsor Spitfires,OHL,67,39,40,79,43,19,13670
2009-10,Windsor Spitfires,M-Cup,4,2,5,7,2,6,13670
2009-10,Södertälje SK J18,J18 Elit,15,15,27,42,61,,20065
2009-10,Södertälje SK J20,SuperElit,27,7,10,17,54,,20065
2009-10,Sweden U18 (all),International-Jr,3,3,0,3,0,,20065
2009-10,USNTDP Juniors,USHL,26,8,15,23,20,15,40260
2009-10,U.S. National U18 Team,USDP,64,20,31,51,50,,40260
2009-10,USA U18,WJC-18,6,1,2,3,6,5,40260
2009-10,Everett Silvertips,WHL,70,4,20,24,68,12,30490
2009-10,EV Landshut U18,DNL,2,1,3,4,0,4,17637
2009-10,Landshut Cannibals,Germany2,38,12,9,21,38,,17637
2009-10,Augsburger Panther,DEL,4,0,0,0,0,0,17637
2009-10,Germany U18,WJC-18 D1,5,4,2,6,2,8,17637
2009-10,DEB U20,DEB-Pokal,2,2,0,2,2,,17637
2009-10,Jokerit U20,Jr. A SM-liiga,17,20,21,41,41,22,16036
2009-10,Jokerit,Liiga,12,1,2,3,6,-10,16036
2009-10,Finland U18,WJC-18,6,10,5,15,10,-2,16036
2009-10,Finland U18 (all),International-Jr,11,10,7,17,4,,16036
2009-10,Finland U20 (all),International-Jr,7,0,8,8,6,,16036
2009-10,Alberni Valley Bulldogs,BCHL,59,26,54,80,44,,45873
2009-10,Team Southeast,USHS-MN,20,5,11,16,25,,75022
2009-10,Bloomington Jefferson High,USHS-MN,25,12,28,40,18,32,75022
2009-10,Milton Academy,USHS-Prep,28,14,21,35,-,,74999
2009-10,Skellefteå AIK J18,J18 Elit,2,0,0,0,2,,13901
2009-10,Skellefteå AIK J18,J18 Allsvenskan,4,0,1,1,0,,13901
2009-10,Skellefteå AIK J20,SuperElit,40,2,7,9,39,,13901
2009-10,Skellefteå AIK,SHL,1,0,0,0,0,0,13901
2009-10,Sweden U18,WJC-18,6,0,1,1,2,4,13901
2009-10,Sweden U18 (all),International-Jr,16,0,1,1,6,,13901
2009-10,Sweden U18/19,WJAC-19,4,0,0,0,0,,13901
2009-10,Cape Breton Screaming Eagles,QMJHL,60,4,25,29,56,17,37281
2009-10,Shattuck St. Mary's Midget Prep,USHS-Prep,55,32,40,72,26,,75029
2009-10,Gatineau Olympiques,QMJHL,50,27,35,62,50,15,37572
2009-10,Mississauga St. Michael's Majors,OHL,65,15,19,34,157,2,37665
2009-10,South Shore Kings,EJHL,44,34,49,83,70,,39429
2009-10,Hamilton Red Wings,CCHL,49,35,40,75,30,17,75045
2009-10,Calgary Hitmen,WHL,39,5,13,18,46,-1,33548
2009-10,Kamloops Blazers,WHL,26,2,7,9,28,-3,33548
2009-10,Oshawa Generals,OHL,68,10,40,50,82,-23,31572
2009-10,Springfield Falcons,AHL,2,0,0,0,0,2,31572
2009-10,Djurgårdens IF J20,SuperElit,9,3,3,6,4,,6047
2009-10,Djurgårdens IF,SHL,54,5,6,11,10,-9,6047
2009-10,Sweden U20 (all),International-Jr,3,1,3,4,6,,6047
2009-10,The Governor's Academy,USHS-Prep,27,21,19,40,112,,75021
2009-10,Niagara IceDogs,OHL,64,25,30,55,12,6,31570
2009-10,Canada U18,WJC-18,6,1,5,6,0,5,31570
2009-10,Owen Sound Attack,OHL,46,17,18,35,101,-11,33632
2009-10,Frölunda HC J18,J18 Elit,10,2,4,6,12,,21717
2009-10,Frölunda HC J18,J18 Allsvenskan,10,1,9,10,10,,21717
2009-10,Frölunda HC J20,SuperElit,27,0,5,5,32,,21717
2009-10,Södertälje SK J20,SuperElit,32,8,29,37,20,,10065
2009-10,Södertälje SK,SHL,27,1,9,10,2,-8,10065
2009-10,Sweden U19 (all),International-Jr,6,3,5,8,2,,10065
2009-10,Sweden U20 (all),International-Jr,3,0,2,2,0,,10065
2009-10,Brandon Wheat Kings,WHL,61,9,19,28,85,16,45473
2009-10,Brandon Wheat Kings,M-Cup,5,0,0,0,15,-2,45473
2009-10,Calgary Hitmen,WHL,51,3,11,14,157,6,37114
2009-10,Calgary Hitmen,M-Cup,2,1,0,1,34,1,37114
2009-10,Northern Michigan Univ.,NCAA,41,12,23,35,22,12,17503
2009-10,Penticton Vees,BCHL,56,0,23,23,51,,46959
2009-10,Portland Winterhawks,WHL,71,12,31,43,70,13,32785
2009-10,Portland Winterhawks,WHL,61,27,30,57,103,17,33566
2009-10,USA U20,WJC-20,7,0,0,0,6,1,33566
2009-10,Delbarton School,USHS-Prep,27,50,33,83,40,,75015
2009-10,U.S. National U18 Team,USDP,2,0,0,0,2,,75015
2009-10,Bloomington Jefferson High,USHS-MN,25,26,28,54,42,37,40252
2009-10,Team Southeast,USHS-MN,24,15,27,42,40,,40252
2009-10,Mississauga St. Michael's Majors,OHL,43,3,5,8,55,-11,33658
2009-10,Brampton Battalion,OHL,66,21,21,42,96,0,32716
2009-10,Prince Edward Island Rocket,QMJHL,66,13,28,41,91,-3,34799
2009-10,Czech Republic U20 (all),International-Jr,4,0,0,0,8,,34799
2009-10,Djurgårdens IF J20,SuperElit,20,5,2,7,12,,10051
2009-10,Djurgårdens IF,SHL,30,2,3,5,26,-6,10051
2009-10,Sweden U20,WJC-20,6,3,2,5,6,5,10051
2009-10,Sweden U20 (all),International-Jr,11,4,2,6,20,,10051
2009-10,Vancouver Giants,WHL,72,41,40,81,111,9,25705
2009-10,Sioux City Musketeers,USHL,53,3,3,6,36,-8,35674
2009-10,USA U18,Hlinka Memorial,4,0,1,1,0,,35674
2009-10,USA U19,WJAC-19,5,0,1,1,4,,35674
2009-10,Cedar Rapids Roughriders,USHL,51,11,11,22,57,4,40237
2009-10,Des Moines Buccaneers,USHL,18,13,6,19,16,3,31285
2009-10,Jungadler Mannheim U18,DNL,24,32,35,67,20,47,34842
2009-10,Heilbronner Falken,Germany2,18,0,3,3,0,,34842
2009-10,Germany U18,WJC-18 D1,5,4,7,11,0,12,34842
2009-10,Germany U20,WJC-20 D1,5,4,2,6,4,7,34842
2009-10,Heilbronner Falken,DEB-Pokal,1,0,0,0,0,,34842
2009-10,Sarnia Sting,OHL,66,6,23,29,75,-38,32748
2009-10,Kingston Frontenacs,OHL,66,15,11,26,31,-5,39752
2009-10,Barrie Colts,OHL,63,7,14,21,121,26,22629
2009-10,Moose Jaw Warriors,WHL,62,4,6,10,70,1,45511
2009-10,Winnipeg South Blues,MJHL,53,29,32,61,55,,40229
2009-10,HV71 J20,SuperElit,37,23,26,49,10,16,10967
2009-10,HV71,SHL,2,0,0,0,0,0,10967
2009-10,Sweden U18 (all),International-Jr,4,0,0,0,12,,10967
2009-10,Sweden U19 (all),International-Jr,6,5,3,8,2,,10967
2009-10,Sweden U18/19,WJAC-19,4,0,2,2,12,,10967
2009-10,Metallurg Novokuznetsk,KHL,21,1,1,2,12,0,19425
2009-10,Kuznetskie Medvedi,MHL,11,6,12,18,26,4,19425
2009-10,Russia U20,WJC-20,6,0,3,3,0,2,19425
2009-10,Russian Selects,Jr Super Series,6,4,0,4,4,-2,19425
2009-10,Great Plains,USHS-MN,17,1,7,8,0,,79185
2009-10,Detroit Lakes High,USHS-MN,25,49,41,90,62,,79185
2009-10,AIK J20,SuperElit,5,4,6,10,2,,13025
2009-10,AIK,Allsvenskan,6,1,2,3,4,2,13025
2009-10,Regina Pats,WHL,59,1,33,34,37,15,45525
2009-10,Halifax Mooseheads,QMJHL,48,5,20,25,28,-26,34836
2009-10,Germany U18,WJC-18 D1,5,2,9,11,4,13,34836
2009-10,Germany U18 (all),International-Jr,7,2,11,13,6,,34836
2009-10,Germany U20,WJC-20 D1,5,0,4,4,6,9,34836
2009-10,Germany U20 (all),International-Jr,5,0,4,4,6,9,34836
2009-10,Saint John Sea Dogs,QMJHL,56,8,13,21,39,18,37425
2009-10,Kootenay Ice,WHL,54,4,9,13,106,-5,33560
2009-10,Chilliwack Bruins,WHL,59,0,6,6,146,-15,45484
2009-10,Indiana Ice,USHL,58,11,29,40,99,11,37758
2009-10,Timrå IK J20,SuperElit,40,3,13,16,118,,10586
2009-10,Timrå IK,SHL,11,0,0,0,0,1,10586
2009-10,Sweden U19 (all),International-Jr,6,0,1,1,4,,10586
2009-10,London Nationals,GOJHL,20,0,7,7,26,,45609
2009-10,London Knights,OHL,53,2,3,5,32,11,45609
2009-10,Tri-City Americans,WHL,72,21,52,73,26,6,32758
2009-10,Niagara IceDogs,OHL,60,23,37,60,94,18,31568
2009-10,Val-d'Or Foreurs,QMJHL,44,5,7,12,43,-8,37403
2009-10,Lewiston MAINEiacs,QMJHL,66,10,32,42,65,-9,37472
2009-10,Chicago Steel,USHL,55,6,10,16,76,3,37830
2009-10,Brandon Wheat Kings,WHL,39,11,17,28,25,13,32806
2009-10,Brandon Wheat Kings,M-Cup,5,0,0,0,5,-3,32806
2009-10,The Gunnery Prep,USHS-Prep,31,2,21,23,20,,75032
2009-10,Indiana Ice,USHL,51,5,14,19,14,-7,31269
2009-10,Dinamo Juniors Riga,Belarus,46,6,3,9,28,-18,34663
2009-10,Latvia U18,WJC-18,6,2,1,3,0,-5,34663
2009-10,Saskatoon Blades,WHL,71,18,30,48,55,19,32770
2009-10,Cushing Academy,USHS-Prep,31,4,18,22,0,,38034
2009-10,Saskatoon Blades,WHL,44,0,3,3,84,-3,19183
2009-10,Univ. of Michigan,NCAA,29,4,8,12,27,2,18883
2009-10,Chilliwack Bruins,WHL,72,22,20,42,57,0,32803
2009-10,Chilliwack Bruins,WHL,6,0,0,0,32,2,37116
2009-10,Saskatoon Blades,WHL,59,6,6,12,131,-4,37116
2009-10,Michigan State Univ.,NCAA,20,7,5,12,10,5,19180
2009-10,Tri-City Americans,WHL,59,16,20,36,14,2,26390
2009-10,EV Landshut U18,DNL,17,10,7,17,63,9,43428
2009-10,Landshut Cannibals,Germany2,29,6,3,9,6,,43428
2009-10,Germany U18,WJC-18 D1,5,0,4,4,14,7,43428
2009-10,Landshut Cannibals,DEB-Pokal,1,0,0,0,0,,43428
2009-10,Severstal Cherepovets,KHL,47,6,8,14,30,-10,11858
2009-10,Almaz Cherepovets,MHL,4,1,0,1,12,2,11858
2009-10,Russia U20,WJC-20,6,2,2,4,6,2,11858
2009-10,Cedar Rapids Roughriders,USHL,60,15,39,54,34,10,15516
2009-10,USNTDP Juniors,USHL,28,5,10,15,22,1,20722
2009-10,U.S. National U17 Team,USDP,2,1,1,2,12,,20722
2009-10,U.S. National U18 Team,USDP,65,18,19,37,36,,20722
2009-10,USA U18,WJC-18,7,2,1,3,2,5,20722
2009-10,Ilves U20,Jr. A SM-liiga,2,0,0,0,2,-1,16049
2009-10,Ilves,Liiga,43,10,9,19,32,1,16049
2009-10,Suomi U20,Mestis,1,0,0,0,0,0,16049
2009-10,Finland U20,WJC-20,6,2,0,2,0,-1,16049
2009-10,Finland U20 (all),International-Jr,14,2,2,4,4,,16049
2009-10,Winnipeg South Blues,MJHL,56,6,25,31,63,,40030
2009-10,Green Bay Gamblers,USHL,52,15,14,29,107,17,37775
2009-10,USA U19,WJAC-19,5,0,1,1,4,,37775
2009-10,Team Northeast,USHS-MN,15,2,4,6,16,,40255
2009-10,Mahtomedi High,USHS-MN,23,18,30,48,40,,40255
2009-10,Mahtomedi High,MN State,3,1,6,7,8,,40255
2009-10,Vernon Vipers,BCHL,41,12,41,53,18,,38013
2009-10,Vernon Vipers,Doyle Cup,7,3,5,8,2,,38013
2009-10,Vernon Vipers,RBC Cup,6,5,4,9,2,,38013
2009-10,Canada West U19,WJAC-19,5,3,3,6,4,,38013
2009-10,St. Thomas Academy,USHS-MN,25,24,33,57,26,,40253
2009-10,Team Southeast,USHS-MN,22,11,11,22,31,,40253
2009-10,Lugano U20,Elite Jr. A,1,0,0,0,0,,17695
2009-10,HC Lugano,NLA,44,1,7,8,14,,17695
2009-10,EHC Visp,NLB,0,0,0,0,0,,17695
2009-10,Switzerland U20,WJC-20,7,3,1,4,4,-4,17695
2009-10,Switzerland U20 (all),International-Jr,19,7,5,12,8,,17695
2009-10,Halifax Mooseheads,QMJHL,54,1,5,6,158,-17,45145
2009-10,AIK J18,J18 Elit,1,0,1,1,0,,10384
2009-10,AIK J18,J18 Allsvenskan,9,2,3,5,0,,10384
2009-10,AIK J20,SuperElit,33,2,6,8,4,,10384
2009-10,Sweden U18 (all),International-Jr,3,0,0,0,2,,10384
2009-10,MODO Hockey J18,J18 Elit,5,4,5,9,0,,13078
2009-10,MODO Hockey J18,J18 Allsvenskan,8,4,2,6,12,,13078
2009-10,MODO Hockey J20,SuperElit,31,16,10,26,18,,13078
2009-10,Sweden U18,WJC-18,6,3,1,4,6,3,13078
2009-10,Sweden U18 (all),International-Jr,10,6,4,10,14,,13078
2009-10,Portland Winterhawks,WHL,66,14,16,30,157,12,32784
2009-10,Kamloops Blazers,WHL,72,29,36,65,83,2,24082
2009-10,Lake Superior State Univ.,NCAA,36,2,6,8,18,-10,49303
2010-11,Red Deer Rebels,WHL,69,31,75,106,51,30,25636
2010-11,Canada U18,Hlinka Memorial,5,5,2,7,6,8,25636
2010-11,Kitchener Rangers,OHL,53,36,30,66,61,27,10393
2010-11,Sweden U20,WJC-20,1,1,1,2,0,3,10393
2010-11,Sweden U20 (all),International-Jr,6,1,3,4,6,,10393
2010-11,Saint John Sea Dogs,QMJHL,67,43,62,105,88,59,45261
2010-11,Saint John Sea Dogs,M-Cup,4,3,3,6,4,3,45261
2010-11,Canada U18,Hlinka Memorial,5,0,3,3,2,3,45261
2010-11,Skellefteå AIK,SHL,37,1,8,9,41,12,10713
2010-11,Sweden U20,WJC-20,6,1,3,4,4,4,10713
2010-11,Sweden U20 (all),International-Jr,15,1,7,8,46,,10713
2010-11,Niagara IceDogs,OHL,65,33,73,106,82,28,44789
2010-11,Djurgårdens IF J18,J18 Elit,2,3,2,5,2,,23856
2010-11,Djurgårdens IF J20,SuperElit,27,12,9,21,12,,23856
2010-11,Djurgårdens IF,SHL,26,5,4,9,2,1,23856
2010-11,Sweden U18,WJC-18,6,4,4,8,2,8,23856
2010-11,Sweden U18 (all),International-Jr,19,13,10,23,14,16,23856
2010-11,Barrie Colts,OHL,66,22,53,75,35,-22,75379
2010-11,Canada U18,WJC-18,7,6,2,8,2,1,75379
2010-11,Drummondville Voltigeurs,QMJHL,58,36,60,96,36,55,32885
2010-11,Canada U20,WJC-20,7,2,1,3,0,6,32885
2010-11,Niagara IceDogs,OHL,67,12,46,58,77,35,45596
2010-11,Canada U18,Hlinka Memorial,5,1,2,3,2,5,45596
2010-11,Färjestad BK J18,J18 Elit,2,0,1,1,2,,19980
2010-11,Färjestad BK,SHL,42,0,4,4,12,6,19980
2010-11,Sweden U18,WJC-18,4,0,1,1,2,3,19980
2010-11,Sweden U18 (all),International-Jr,13,3,3,6,22,6,19980
2010-11,Sweden U20 (all),International-Jr,3,0,1,1,0,,19980
2010-11,Färjestad BK,ET,4,0,1,1,2,,19980
2010-11,Saskatoon Blades,WHL,72,5,38,43,121,40,37238
2010-11,Canada U18,Hlinka Memorial,5,1,2,3,6,8,37238
2010-11,Kitchener Rangers,OHL,63,26,53,79,36,22,44666
2010-11,Canada U18,WJC-18,7,4,9,13,2,2,44666
2010-11,Portland Winterhawks,WHL,66,34,51,85,74,23,33591
2010-11,Switzerland U20,WJC-20,6,1,1,2,4,-5,33591
2010-11,Switzerland U20 (all),International-Jr,15,3,5,8,6,,33591
2010-11,Northeastern Univ.,NCAA,38,4,9,13,57,15,37832
2010-11,USNTDP Juniors,USHL,21,3,12,15,48,4,38624
2010-11,U.S. National U18 Team,USDP,35,12,23,35,38,,38624
2010-11,USA U18,WJC-18,6,4,8,12,6,8,38624
2010-11,Ässät,Liiga,48,18,11,29,24,9,40624
2010-11,Suomi U20,Mestis,4,0,3,3,6,0,40624
2010-11,Finland U18,WJC-18,6,4,9,13,8,2,40624
2010-11,Finland U18 (all),International-Jr,12,7,13,20,16,6,40624
2010-11,Finland U20,WJC-20,6,0,1,1,2,1,40624
2010-11,Finland U20 (all),International-Jr,10,0,3,3,8,,40624
2010-11,Saint John Sea Dogs,QMJHL,65,12,33,45,52,44,37422
2010-11,Saint John Sea Dogs,M-Cup,4,1,2,3,2,0,37422
2010-11,Prince Albert Raiders,WHL,70,32,49,81,53,-4,26414
2010-11,Canada U18,WJC-18,7,0,6,6,2,-3,26414
2010-11,Färjestad BK J18,J18 Elit,3,1,2,3,0,,16804
2010-11,Färjestad BK J18,J18 Allsvenskan,5,2,1,3,2,,16804
2010-11,Färjestad BK,SHL,23,1,1,2,2,1,16804
2010-11,Skåre BK,Division 1,12,0,1,1,0,,16804
2010-11,Sweden U18,WJC-18,6,1,3,4,4,4,16804
2010-11,Sweden U18 (all),International-Jr,17,2,12,14,8,9,16804
2010-11,USNTDP Juniors,USHL,9,3,1,4,6,6,45417
2010-11,U.S. National U17 Team,USDP,2,0,0,0,4,,45417
2010-11,U.S. National U18 Team,USDP,22,6,4,10,6,,45417
2010-11,USA U18,WJC-18,6,3,1,4,2,7,45417
2010-11,USA U18,Hlinka Memorial,5,1,3,4,1,,45417
2010-11,Plymouth Whalers,OHL,68,34,43,77,80,14,45567
2010-11,USNTDP Juniors,USHL,20,7,4,11,41,8,38619
2010-11,U.S. National U18 Team,USDP,55,19,12,31,161,8,38619
2010-11,USA U18,WJC-18,6,2,1,3,49,3,38619
2010-11,Portland Winterhawks,WHL,60,9,40,49,67,23,37180
2010-11,Peterborough Petes,OHL,55,34,35,69,49,-33,45571
2010-11,Canada U18,Hlinka Memorial,5,3,4,7,2,7,45571
2010-11,Mississauga St. Michael's Majors,OHL,64,4,29,33,50,50,45602
2010-11,Mississauga St. Michael's Majors,M-Cup,5,0,4,4,4,1,45602
2010-11,Canada U18,Hlinka Memorial,5,0,0,0,0,3,45602
2010-11,Victoriaville Tigres,QMJHL,64,23,44,67,59,17,45282
2010-11,Canada U18,Hlinka Memorial,5,0,3,3,4,4,45282
2010-11,London Knights,OHL,68,30,38,68,49,12,39029
2010-11,Russian Selects,Jr Super Series,1,0,0,0,0,0,39029
2010-11,Saint John Sea Dogs,QMJHL,67,38,57,95,16,48,44594
2010-11,Saint John Sea Dogs,M-Cup,4,1,4,5,0,3,44594
2010-11,Oshawa Generals,OHL,61,29,29,58,42,14,32422
2010-11,Denmark U20,WJC-20 D1,5,2,3,5,10,3,32422
2010-11,Plymouth Whalers,OHL,49,20,25,45,12,14,17435
2010-11,Sweden U18 (all),International-Jr,5,0,2,2,4,0,17435
2010-11,Sweden U20,WJC-20,5,0,3,3,2,-3,17435
2010-11,Sweden U20 (all),International-Jr,7,0,3,3,4,,17435
2010-11,Vancouver Giants,WHL,62,6,19,25,83,1,23298
2010-11,Czech Republic U18,WJC-18,5,0,0,0,6,-1,23298
2010-11,Czech Republic U18 (all),International-Jr,6,1,0,1,8,,23298
2010-11,Czech Republic U20 (all),International-Jr,3,0,0,0,2,,23298
2010-11,Portland Winterhawks,WHL,67,28,51,79,55,20,26385
2010-11,USNTDP Juniors,USHL,23,12,13,25,18,10,38622
2010-11,U.S. National U18 Team,USDP,58,39,34,73,65,,38622
2010-11,USA U18,WJC-18,6,2,6,8,6,5,38622
2010-11,Youngstown Phantoms,USHL,52,7,9,16,159,-18,45906
2010-11,USA U19,WJAC-19,4,0,1,1,4,,45906
2010-11,Saint John Sea Dogs,QMJHL,60,31,25,56,17,46,34751
2010-11,Slovakia U20,WJC-20,6,1,0,1,0,0,34751
2010-11,Saint John Sea Dogs,M-Cup,4,4,1,5,2,3,34751
2010-11,Boston Univ.,NCAA,39,5,21,26,80,8,20714
2010-11,Oshawa Generals,OHL,63,25,41,66,57,10,45587
2010-11,Canada U18,Hlinka Memorial,5,2,1,3,0,2,45587
2010-11,Windsor Spitfires,OHL,67,34,42,76,28,9,41925
2010-11,HC Slavia Praha U20,Czech U20,1,0,0,0,0,1,65564
2010-11,HC Slavia Praha,Czech,33,3,7,10,16,4,65564
2010-11,Czech Republic U18,WJC-18,6,4,1,5,10,-2,65564
2010-11,Czech Republic U18 (all),International-Jr,13,8,6,14,16,-1,65564
2010-11,Czech Republic U20 (all),International-Jr,1,3,0,3,2,,65564
2010-11,Leksands IF J18,J18 Allsvenskan,4,4,4,8,0,,15747
2010-11,Leksands IF J20,SuperElit,13,3,9,12,2,,15747
2010-11,Leksands IF,Allsvenskan,37,5,6,11,8,-5,15747
2010-11,Sweden U18,WJC-18,6,2,3,5,4,5,15747
2010-11,Sweden U18 (all),International-Jr,20,4,16,20,12,7,15747
2010-11,Saginaw Spirit,OHL,59,27,28,55,47,8,31264
2010-11,Sarnia Sting,OHL,49,21,20,41,47,-1,45554
2010-11,Canada U18,WJC-18,7,4,3,7,6,0,45554
2010-11,Canada U18,Hlinka Memorial,5,4,0,4,2,5,45554
2010-11,HIFK U20,Jr. A SM-liiga,40,20,32,52,49,5,19426
2010-11,HIFK,Liiga,2,0,0,0,0,0,19426
2010-11,Suomi U20,Mestis,6,3,3,6,6,3,19426
2010-11,Finland U18,WJC-18,6,2,8,10,6,4,19426
2010-11,Finland U18 (all),International-Jr,23,14,19,33,14,4,19426
2010-11,Finland U20 (all),International-Jr,3,0,2,2,0,,19426
2010-11,Moose Jaw Warriors,WHL,71,2,18,20,95,3,59478
2010-11,Boston Univ.,NCAA,39,10,13,23,16,-1,20723
2010-11,Montréal Juniors,QMJHL,67,8,35,43,44,27,45164
2010-11,Canada U18,Hlinka Memorial,5,1,1,2,2,2,45164
2010-11,Frölunda HC J20,SuperElit,15,10,9,19,4,,16727
2010-11,Frölunda HC,SHL,41,1,0,1,10,-7,16727
2010-11,Borås HC,Allsvenskan,1,0,0,0,0,0,16727
2010-11,Sweden U19 (all),International-Jr,7,9,6,15,10,,16727
2010-11,Sweden U20,WJC-20,6,0,1,1,0,-1,16727
2010-11,Sweden U20 (all),International-Jr,14,0,4,4,4,,16727
2010-11,Frölunda HC,ET,8,1,0,1,2,,16727
2010-11,Jokerit U20,Jr. A SM-liiga,41,18,13,31,14,10,45423
2010-11,Jokerit,Liiga,1,0,0,0,0,0,45423
2010-11,Suomi U20,Mestis,2,1,1,2,0,-1,45423
2010-11,Finland U19 (all),International-Jr,7,4,4,8,8,,45423
2010-11,Finland U20 (all),International-Jr,4,0,0,0,2,,45423
2010-11,Kärpät,Liiga,40,4,6,10,53,2,43419
2010-11,Suomi U20,Mestis,3,1,1,2,27,0,43419
2010-11,Finland U18,WJC-18,6,4,2,6,2,0,43419
2010-11,Finland U18 (all),International-Jr,12,7,4,11,8,2,43419
2010-11,Finland U20,WJC-20,6,2,1,3,14,3,43419
2010-11,Finland U20 (all),International-Jr,13,3,1,4,28,,43419
2010-11,Kärpät,ET,5,0,0,0,4,,43419
2010-11,VIK Västerås HK J18,J18 Elit,5,2,4,6,6,,19432
2010-11,VIK Västerås HK J18,J18 Allsvenskan,6,3,5,8,4,,19432
2010-11,VIK Västerås HK J20,SuperElit,38,20,34,54,45,,19432
2010-11,VIK Västerås HK,Allsvenskan,14,1,3,4,2,0,19432
2010-11,Sweden U18,WJC-18,6,2,3,5,6,8,19432
2010-11,Sweden U18 (all),International-Jr,15,2,6,8,60,11,19432
2010-11,London Knights,OHL,67,6,16,22,51,-14,39653
2010-11,Canada U18,WJC-18,7,0,0,0,8,2,39653
2010-11,Canada U18,Hlinka Memorial,5,1,1,2,4,9,39653
2010-11,Vaughan Vipers,OJHL,3,1,2,3,4,,62407
2010-11,Sault Ste. Marie Greyhounds,OHL,61,14,19,33,36,-15,62407
2010-11,Oshawa Generals,OHL,66,27,27,54,66,8,45173
2010-11,Canada U18,Hlinka Memorial,5,3,2,5,2,5,45173
2010-11,Portland Winterhawks,WHL,64,2,10,12,73,0,37182
2010-11,CSKA Moskva,KHL,9,0,2,2,0,-3,77237
2010-11,Krasnaya Armiya Moskva,MHL,41,27,31,58,81,42,77237
2010-11,Russia U18,WJC-18,7,11,10,21,6,10,77237
2010-11,Russia U19,WJAC-19,4,2,5,7,2,,77237
2010-11,Russia U18,Hlinka Memorial,4,1,1,2,2,-3,77237
2010-11,Rögle BK J18,J18 Allsvenskan,0,0,0,0,0,0,23185
2010-11,Rögle BK J20,SuperElit,17,1,3,4,8,3,23185
2010-11,Rögle BK,Allsvenskan,45,2,7,9,6,-8,23185
2010-11,Sweden U18,WJC-18,6,0,4,4,2,8,23185
2010-11,Sweden U18 (all),International-Jr,19,3,9,12,12,10,23185
2010-11,U.S. National U18 Team,USDP,15,4,1,5,0,,75068
2010-11,USNTDP Juniors,USHL,6,3,0,3,0,-3,75068
2010-11,Wayzata High,USHS-MN,24,25,22,47,14,26,75068
2010-11,Team Northwest,USHS-MN,10,6,6,12,4,,75068
2010-11,Ottawa 67's,OHL,59,25,63,88,18,43,32724
2010-11,Guelph Storm,OHL,51,2,10,12,89,-11,79402
2010-11,Russia U18,WJC-18,6,0,2,2,25,4,79402
2010-11,Russian Selects,Jr Super Series,1,0,0,0,4,0,79402
2010-11,Russia U18,Hlinka Memorial,4,0,0,0,8,4,79402
2010-11,Saginaw Spirit,OHL,68,26,36,62,60,14,45560
2010-11,Mississauga St. Michael's Majors,OHL,59,12,20,32,101,22,45600
2010-11,Mississauga St. Michael's Majors,M-Cup,5,0,0,0,8,-2,45600
2010-11,Univ. of Notre Dame,NCAA,44,23,31,54,36,19,45686
2010-11,Swift Current Broncos,WHL,66,18,27,45,84,-21,45633
2010-11,Sault Ste. Marie Greyhounds,OHL,68,29,39,68,56,-14,45550
2010-11,Canada U18,WJC-18,7,4,4,8,10,3,45550
2010-11,USNTDP Juniors,USHL,24,0,5,5,35,0,38626
2010-11,U.S. National U18 Team,USDP,60,1,14,15,77,,38626
2010-11,USA U18,WJC-18,6,0,1,1,2,-1,38626
2010-11,Edina High,USHS-MN,24,23,17,40,12,,114771
2010-11,Team Southwest,USHS-MN,19,10,4,14,10,,114771
2010-11,Chicago Steel,USHL,6,2,0,2,2,-10,114771
2010-11,Edina High,MN State,3,1,3,4,0,0,114771
2010-11,Edmonton Oil Kings,WHL,71,2,22,24,123,33,45485
2010-11,Edmonton Oil Kings,WHL,72,16,11,27,126,-3,37130
2010-11,Canada U18,WJC-18,7,0,1,1,4,1,37130
2010-11,Indiana Ice,USHL,59,34,58,92,72,52,46889
2010-11,Cape Breton Screaming Eagles,QMJHL,68,26,20,46,37,-18,37280
2010-11,Sault Ste. Marie Greyhounds,OHL,67,26,45,71,117,-5,41287
2010-11,Canada U18,WJC-18,7,0,2,2,22,1,41287
2010-11,Canada U18,Hlinka Memorial,5,2,2,4,12,6,41287
2010-11,Stouffville Spirit,OJHL,36,3,27,30,29,,76695
2010-11,Canada East U19,WJAC-19,5,0,0,0,0,,76695
2010-11,Linköping HC,SHL,47,0,8,8,12,7,13266
2010-11,Sweden U20,WJC-20,6,0,2,2,2,1,13266
2010-11,Sweden U20 (all),International-Jr,11,0,2,2,2,,13266
2010-11,Sweden (all),International,4,0,0,0,2,-1,13266
2010-11,Linköping HC,ET,8,0,0,0,2,,13266
2010-11,Oshawa Generals,OHL,66,33,42,75,109,34,32736
2010-11,Saginaw Spirit,OHL,64,8,9,17,132,-9,45561
2010-11,Univ. of Denver,NCAA,33,7,11,18,37,0,20724
2010-11,Green Bay Gamblers,USHL,51,6,8,14,14,10,75052
2010-11,Prince Albert Raiders,WHL,54,0,9,9,98,8,45515
2010-11,Kingston Frontenacs,OHL,17,4,7,11,2,-1,45411
2010-11,Peterborough Petes,OHL,52,22,20,42,6,-35,45411
2010-11,Canada U18,WJC-18,7,1,6,7,6,-2,45411
2010-11,Canada U18,Hlinka Memorial,5,1,2,3,0,4,45411
2010-11,Sudbury Wolves,OHL,64,13,17,30,37,-10,88692
2010-11,Shawinigan Cataractes,QMJHL,68,2,5,7,86,0,45270
2010-11,Sudbury Wolves,OHL,66,5,6,11,124,-8,45548
2010-11,Saint-Jérôme Panthères,QJAAAHL,33,25,35,60,34,23,64591
2010-11,Québec Remparts,QMJHL,31,9,15,24,6,-1,64591
2010-11,Team Southwest,USHS-MN,19,16,7,23,14,,75072
2010-11,Eden Prairie High,USHS-MN,25,33,36,69,8,,75072
2010-11,Sioux Falls Stampede,USHL,11,4,6,10,15,4,75072
2010-11,Eden Prairie High,MN State,3,5,2,7,2,,75072
2010-11,Univ. of North Dakota,NCAA,30,2,8,10,8,10,44487
2010-11,Linköping HC J18,J18 Elit,1,0,0,0,4,,16772
2010-11,Linköping HC J18,J18 Allsvenskan,3,1,3,4,0,,16772
2010-11,Linköping HC J20,SuperElit,37,8,18,26,16,,16772
2010-11,Linköping HC,SHL,12,0,1,1,2,-1,16772
2010-11,Sweden U18,WJC-18,5,1,0,1,4,-2,16772
2010-11,Sweden U18 (all),International-Jr,19,8,9,17,22,5,16772
2010-11,Linköping HC,ET,3,0,0,0,0,,16772
2010-11,Saginaw Spirit,OHL,68,47,25,72,62,24,37624
2010-11,USNTDP Juniors,USHL,24,0,6,6,11,7,38628
2010-11,U.S. National U18 Team,USDP,60,4,26,30,27,,38628
2010-11,USA U18,WJC-18,6,1,7,8,4,5,38628
2010-11,Gatineau Olympiques,QMJHL,67,32,47,79,22,23,45134
2010-11,Cedar Rapids Roughriders,USHL,58,8,13,21,81,5,89813
2010-11,Shattuck St. Mary's Midget Prep,USHS-Prep,54,14,34,48,30,,106295
2010-11,USNTDP Juniors,USHL,24,14,6,20,13,6,38620
2010-11,U.S. National U18 Team,USDP,57,32,22,54,35,,38620
2010-11,USA U18,WJC-18,6,8,2,10,8,9,38620
2010-11,Mora IK J18,J18 Elit,11,1,7,8,10,,33189
2010-11,Mora IK J20,SuperElit,37,2,6,8,26,,33189
2010-11,Mora IK,Allsvenskan,3,0,0,0,0,1,33189
2010-11,Sweden U18,WJC-18,6,0,1,1,6,0,33189
2010-11,Sweden U18 (all),International-Jr,7,1,1,2,6,1,33189
2010-11,Team Southeast,USHS-MN,5,2,6,8,2,,75066
2010-11,Academy of Holy Angels,USHS-MN,25,27,22,49,42,27,75066
2010-11,Shawinigan Cataractes,QMJHL,68,19,29,48,40,-9,45271
2010-11,Ambrì-Piotta U20,Elite Jr. A,2,2,0,2,2,,66536
2010-11,HC Ambrì-Piotta,NLA,41,3,9,12,2,-6,66536
2010-11,Switzerland U20,WJC-20,6,1,3,4,2,2,66536
2010-11,Switzerland U20 (all),International-Jr,18,6,9,15,10,,66536
2010-11,Switzerland U20,WJAC-19,4,4,2,6,6,,66536
2010-11,Dubuque Fighting Saints,USHL,60,36,36,72,36,21,88391
2010-11,USA U18,Hlinka Memorial,5,2,2,4,0,,88391
2010-11,Brynäs IF J18,J18 Elit,20,17,31,48,8,35,22269
2010-11,Brynäs IF J18,J18 Allsvenskan,16,14,19,33,52,11,22269
2010-11,Brynäs IF J20,SuperElit,9,0,1,1,2,-4,22269
2010-11,Edmonton Oil Kings,WHL,68,27,48,75,48,28,37126
2010-11,Seattle Thunderbirds,WHL,68,22,22,44,69,-19,32767
2010-11,Val-d'Or Foreurs,QMJHL,65,20,33,53,28,-7,45274
2010-11,Traktor Chelyabinsk,KHL,6,0,1,1,0,-2,58566
2010-11,Belye Medvedi Chelyabinsk,MHL,39,22,14,36,42,13,58566
2010-11,Russia U18,WJC-18,6,2,1,3,0,-3,58566
2010-11,Russia U18 (all),International-Jr,18,5,4,9,8,,58566
2010-11,Russia U19,WJAC-19,4,0,0,0,8,,58566
2010-11,Russia U18,Hlinka Memorial,4,2,1,3,0,2,58566
2010-11,Univ. of Wisconsin,NCAA,41,8,11,19,32,23,20721
2010-11,Medicine Hat Tigers,WHL,65,10,14,24,129,5,26412
2010-11,Boston Univ.,NCAA,38,4,11,15,89,5,48219
2010-11,Färjestad BK,SHL,22,4,11,15,4,-2,10538
2010-11,Bofors IK,Allsvenskan,35,5,6,11,10,0,10538
2010-11,Färjestad BK,ET,1,0,0,0,0,,10538
2010-11,Kitchener Rangers,OHL,65,23,26,49,35,9,34851
2010-11,Germany U18,WJC-18,3,3,0,3,0,1,34851
2010-11,Germany U20,WJC-20,6,1,1,2,0,-4,34851
2010-11,Vancouver Giants,WHL,12,6,5,11,14,3,34760
2010-11,Oshawa Generals,OHL,59,0,14,14,70,21,45589
2010-11,Seattle Thunderbirds,WHL,66,28,26,54,23,-11,34847
2010-11,Germany U20,WJC-20,6,1,2,3,0,-4,34847
2010-11,Tri-City Americans,WHL,72,8,24,32,65,41,37266
2010-11,Djurgårdens IF J18,J18 Elit,8,2,11,13,4,,21651
2010-11,Djurgårdens IF J18,J18 Allsvenskan,1,0,0,0,0,,21651
2010-11,Djurgårdens IF J20,SuperElit,35,3,4,7,14,,21651
2010-11,Sweden U18,WJC-18,6,0,0,0,0,0,21651
2010-11,Sweden U18 (all),International-Jr,15,0,4,4,33,3,21651
2010-11,Indiana Ice,USHL,55,25,48,73,26,26,45729
2010-11,HC Presov U18,Slovakia U18,8,3,4,7,22,,89280
2010-11,HC Kosice U20,Slovakia U20,28,3,15,18,20,24,89280
2010-11,Slovakia U18,WJC-18,6,0,1,1,2,0,89280
2010-11,Plymouth Whalers,OHL,68,10,30,40,61,7,45565
2010-11,Canada U18,Hlinka Memorial,5,1,2,3,4,4,45565
2010-11,Stalnye Lisy Magnitogorsk,MHL,42,11,10,21,22,12,93879
2010-11,Red Deer Rebels,WHL,68,33,28,61,34,37,20380
2010-11,Djurgårdens IF J20,SuperElit,18,2,3,5,6,,14412
2010-11,Djurgårdens IF,SHL,35,2,0,2,6,4,14412
2010-11,Sweden U19 (all),International-Jr,7,0,1,1,29,,14412
2010-11,Sweden U20 (all),International-Jr,3,0,0,0,2,,14412
2010-11,Djurgårdens IF,ET,5,0,1,1,25,,14412
2010-11,Spokane Chiefs,WHL,64,23,58,81,31,55,32763
2010-11,Omaha Lancers,USHL,56,24,22,46,89,3,37875
2010-11,USA U19,WJAC-19,4,2,3,5,2,,37875
2010-11,USNTDP Juniors,USHL,24,4,5,9,20,-4,45418
2010-11,U.S. National U18 Team,USDP,60,14,9,23,53,,45418
2010-11,USA U18,WJC-18,6,1,0,1,0,-4,45418
2010-11,Wayzata High,USHS-MN,25,15,39,54,26,29,117577
2010-11,Team Northwest,USHS-MN,21,16,17,33,18,,117577
2010-11,Eden Prairie High,USHS-MN,22,7,27,34,38,,107099
2010-11,Team Southwest,USHS-MN,21,3,7,10,32,,107099
2010-11,Eden Prairie High,MN State,3,2,4,6,6,,107099
2010-11,Indiana Ice,USHL,51,8,21,29,45,5,49938
2010-11,USA U18,Hlinka Memorial,5,1,0,1,4,-1,49938
2010-11,Kelowna Rockets,WHL,67,21,45,66,62,3,32798
2010-11,Philadelphia Revolution,EmJHL,9,1,9,10,10,,96876
2010-11,Philadelphia Revolution,EJHL,18,1,2,3,33,,96876
2010-11,Victoriaville Tigres,QMJHL,23,1,3,4,21,8,96876
2010-11,Baie-Comeau Drakkar,QMJHL,67,5,5,10,141,-13,68120
2010-11,Saginaw Spirit,OHL,24,0,3,3,33,5,45563
2010-11,Barrie Colts,OHL,15,0,3,3,42,-8,45563
2010-11,Saskatoon Blades,WHL,68,8,19,27,66,17,52798
2010-11,Owen Sound Attack,OHL,66,22,32,54,135,17,37671
2010-11,Owen Sound Attack,M-Cup,4,2,5,7,16,2,37671
2010-11,Victoria Grizzlies,BCHL,42,24,43,67,35,,26409
2010-11,Saskatoon Blades,WHL,72,35,22,57,125,27,33572
2010-11,Malmö Redhawks J18,J18 Elit,15,10,11,21,26,,22501
2010-11,Malmö Redhawks J18,J18 Allsvenskan,4,0,1,1,6,,22501
2010-11,Malmö Redhawks J20,SuperElit,32,3,10,13,34,,22501
2010-11,Malmö Redhawks,Allsvenskan,4,0,0,0,0,1,22501
2010-11,Skövde IK J20,J20 Elit,2,1,3,4,2,,13766
2010-11,Skövde IK,Division 1,34,13,27,40,6,9,13766
2010-11,Sweden U19 (all),International-Jr,7,3,7,10,0,,13766
2010-11,Sweden U20,WJC-20,6,2,0,2,4,1,13766
2010-11,Sweden U20 (all),International-Jr,14,4,3,7,22,,13766
2010-11,Spokane Chiefs,WHL,65,21,39,60,60,19,41098
2010-11,Choate Rosemary Hall,USHS-Prep,22,10,10,20,44,,56641
2010-11,Linköping HC J20,SuperElit,27,2,18,20,34,,12949
2010-11,Linköping HC,SHL,6,0,0,0,4,-2,12949
2010-11,Mjölby HC,Division 1,2,1,2,3,2,,12949
2010-11,Sweden U19 (all),International-Jr,7,2,3,5,4,,12949
2010-11,Linköping HC,ET,5,0,0,0,4,,12949
2010-11,Sweden U18/19,WJAC-19,4,0,1,1,4,,12949
2010-11,RPI (Rensselaer Polytech. Inst.),NCAA,31,1,2,3,14,-4,75055
2010-11,Belye Medvedi Chelyabinsk,MHL,46,5,14,19,72,-2,70425
2010-11,Russia U18,WJC-18,7,2,2,4,29,11,70425
2010-11,Russia U19,WJAC-19,4,1,0,1,6,,70425
2010-11,Belleville Bulls,OHL,67,19,15,34,78,-19,45539
2010-11,Canada U18,WJC-18,7,0,1,1,2,1,45539
2010-11,Canada U18,Hlinka Memorial,5,0,1,1,6,5,45539
2010-11,Sudbury Wolves,OHL,67,4,26,30,94,-10,45547
2010-11,Milton Academy,USHS-Prep,30,2,7,9,22,,128376
2010-11,Erie Otters,OHL,41,8,14,22,51,-11,45404
2010-11,Sault Ste. Marie Greyhounds,OHL,24,5,7,12,34,1,45404
2010-11,Canada U18,Hlinka Memorial,5,0,2,2,20,5,45404
2010-11,Val-d'Or Foreurs,QMJHL,66,3,15,18,73,-27,22857
2010-11,Burnsville High,USHS-MN,25,9,14,23,28,,117575
2010-11,Niagara IceDogs,OHL,2,1,0,1,0,-2,45594
2010-11,Owen Sound Attack,OHL,58,27,35,62,18,19,45594
2010-11,Owen Sound Attack,M-Cup,4,1,1,2,0,0,45594
2010-11,Grande Prairie Storm,AJHL,10,4,1,5,28,,23970
2010-11,Spokane Chiefs,WHL,68,7,7,14,306,10,23970
2010-11,HC Ceske Budejovice U18,Czech U18,0,0,0,0,0,,56037
2010-11,HC Ceské Budejovice U20,Czech U20,47,14,13,27,65,17,56037
2010-11,Czech Republic U18,WJC-18,5,3,1,4,2,-3,56037
2010-11,Czech Republic U18 (all),International-Jr,18,6,4,10,20,-10,56037
2010-11,Swift Current Broncos,WHL,72,6,18,24,59,-37,37209
2010-11,Canada U18,WJC-18,7,0,0,0,0,-4,37209
2010-11,Salmon Arm Silverbacks,BCHL,57,12,35,47,80,,47762
2010-11,Saint John Sea Dogs,QMJHL,59,8,27,35,38,26,56060
2010-11,Saint John Sea Dogs,M-Cup,4,1,0,1,2,0,56060
2010-11,Saskatoon Blades,WHL,71,14,12,26,53,13,79504
2010-11,Lokomotiv Yaroslavl,KHL,16,1,1,2,4,-1,38658
2010-11,Loko Yaroslavl,MHL,14,10,10,20,8,9,38658
2010-11,Russia U20,WJC-20,7,4,3,7,4,5,38658
2010-11,,,,,,,,,38658
2010-11,Russian Selects,Jr Super Series,6,1,3,4,4,1,38658
2010-11,HC Sparta Praha U20,Czech U20,41,27,31,58,22,37,101160
2010-11,HC Sparta Praha,Czech,3,0,0,0,0,-1,101160
2010-11,HC Berounsti Medvedi,Czech2,1,0,0,0,0,0,101160
2010-11,Czech Republic U20 (all),International-Jr,8,3,4,7,0,,101160
2010-11,Camrose Kodiaks,AJHL,50,6,16,22,56,,54059
2010-11,Camrose Kodiaks,RBC Cup,5,1,4,5,4,,54059
2010-11,Canada West U19,WJAC-19,5,0,1,1,4,,54059
2010-11,Western Michigan Univ.,NCAA,42,12,18,30,12,5,20717
2010-11,Sioux City Musketeers,USHL,55,21,21,42,102,6,90365
2010-11,USA U19,WJAC-19,4,1,2,3,4,,90365
2010-11,HK Dukla Trencin U18,Slovakia U18,0,0,0,0,0,,66434
2010-11,HK Dukla Trencin U20,Slovakia U20,8,0,3,3,4,10,66434
2010-11,HK Dukla Trencin,Slovakia,7,0,0,0,0,-2,66434
2010-11,HK Orange 20,Slovakia,25,1,3,4,16,-27,66434
2010-11,Slovakia U18,WJC-18,6,0,1,1,0,-6,66434
2010-11,Slovakia U20,WJC-20,6,0,0,0,2,-3,66434
2010-11,Brown Univ.,NCAA,30,6,11,17,48,-7,46692
2010-11,Brainerd High,USHS-MN,25,27,46,73,40,,122788
2010-11,Team North,USHS-MN,21,8,7,15,49,,122788
2010-11,Swift Current Broncos,WHL,66,0,10,10,107,-15,79399
2010-11,Hotchkiss School,USHS-Prep,16,8,9,17,-,,75049
2010-11,USNTDP Juniors,USHL,24,5,13,18,10,2,38621
2010-11,U.S. National U18 Team,USDP,60,13,25,38,16,,38621
2010-11,USA U18,WJC-18,6,2,4,6,2,5,38621
2010-11,Mississauga St. Michael's Majors,OHL,67,3,24,27,70,31,45603
2010-11,Mississauga St. Michael's Majors,M-Cup,5,0,0,0,4,3,45603
2010-11,Malmö Redhawks J20,SuperElit,26,32,25,57,8,,13146
2010-11,Malmö Redhawks,Allsvenskan,34,8,13,21,8,18,13146
2010-11,Sweden U19 (all),International-Jr,11,4,15,19,2,,13146
2010-11,Malmö Redhawks,ET,3,0,0,0,0,,13146
2010-11,Sweden U18/19,WJAC-19,4,0,4,4,2,,13146
2010-11,Shawinigan Cataractes,QMJHL,63,1,7,8,153,-10,45161
2010-11,KalPa U20,Jr. A SM-liiga,4,3,2,5,6,5,30857
2010-11,KalPa,Liiga,46,7,3,10,34,0,30857
2010-11,Suomi U20,Mestis,3,0,0,0,0,-3,30857
2010-11,Finland U20,WJC-20,6,1,2,3,2,3,30857
2010-11,Finland U20 (all),International-Jr,14,5,2,7,10,,30857
2010-11,Niagara IceDogs,OHL,66,9,11,20,52,-1,45635
2010-11,Brandon Wheat Kings,WHL,63,6,12,18,72,4,56582
2010-11,Green Bay Gamblers,USHL,51,7,14,21,73,17,37787
2010-11,USA U19,WJAC-19,4,0,0,0,6,,37787
2010-11,Benilde-St. Margaret's School,USHS-MN,25,3,34,37,14,47,131134
2010-11,Ottawa 67's,OHL,66,10,11,21,10,-4,45582
2010-11,Jokerit,Liiga,48,2,11,13,24,-2,17284
2010-11,Jokerit,ET,7,0,0,0,2,,17284
2010-11,Lethbridge Hurricanes,WHL,46,18,24,42,35,1,29016
2010-11,St. John's Prep,USHS-Prep,25,33,33,66,-,,128394
2010-11,Boston Jr. Bruins,EJHL,-,-,-,-,-,,128394
2010-11,Ilves U20,Jr. A SM-liiga,3,0,0,0,6,-2,25488
2010-11,Ilves,Liiga,48,1,8,9,18,5,25488
2010-11,LeKi,Mestis,1,0,0,0,0,-2,25488
2010-11,Suomi U20,Mestis,6,0,3,3,2,1,25488
2010-11,Finland U20,WJC-20,6,1,2,3,4,5,25488
2010-11,Finland U20 (all),International-Jr,17,1,3,4,14,,25488
2010-11,USNTDP Juniors,USHL,24,6,3,9,16,1,38623
2010-11,U.S. National U18 Team,USDP,57,9,9,18,26,,38623
2010-11,USA U18,WJC-18,6,1,4,5,4,4,38623
2010-11,Waupaca High,USHS-WI,14,29,23,52,40,,128391
2010-11,Avon Old Farms School,USHS-Prep,27,3,12,15,14,,75063
2010-11,Green Bay Gamblers,USHL,55,13,20,33,22,15,90896
2010-11,USA U18,Hlinka Memorial,5,1,0,1,0,-2,90896
2010-11,Frölunda HC J18,J18 Elit,10,12,7,19,8,,22270
2010-11,Frölunda HC J18,J18 Allsvenskan,15,6,7,13,10,,22270
2010-11,Frölunda HC J20,SuperElit,22,4,3,7,28,,22270
2010-11,Pembroke Lumber Kings,CHL T1,50,26,46,72,14,,78295
2010-11,Pembroke Lumber Kings,Fred Page Cup,4,7,5,12,0,,78295
2010-11,Pembroke Lumber Kings,RBC Cup,6,2,3,5,0,,78295
2010-11,Canada East U19,WJAC-19,5,2,2,4,2,,78295
2010-11,Halifax Mooseheads,QMJHL,68,12,17,29,33,-22,45143
2010-11,Canada U18,WJC-18,7,0,1,1,14,-3,45143
2010-11,Edina High,USHS-MN,22,4,17,21,20,,94244
2010-11,Team Southwest,USHS-MN,7,1,4,5,0,,94244
2010-11,USNTDP Juniors,USHL,5,1,1,2,2,-2,94244
2010-11,U.S. National U18 Team,USDP,17,1,2,3,12,,94244
2010-11,Edina High,MN State,3,0,2,2,2,1,94244
2010-11,Lincoln Stars,USHL,54,23,44,67,8,19,49315
2010-11,USA U19,WJAC-19,4,0,3,3,0,,49315
2010-11,CSKA Moskva,KHL,22,0,2,2,4,-2,40249
2010-11,Krasnaya Armiya Moskva,MHL,36,5,33,38,28,33,40249
2010-11,Peterborough Petes,OHL,55,1,4,5,173,-11,75894
2010-11,Fargo Force,USHL,51,7,16,23,38,9,75060
2010-11,Drummondville Voltigeurs,QMJHL,61,39,57,96,24,37,18097
2010-11,Czech Republic U20,WJC-20,6,2,1,3,0,1,18097
2010-11,Czech Republic U20 (all),International-Jr,9,2,3,5,2,,18097
2010-11,Georgetown Raiders,OJHL,42,20,41,61,59,,62534
2010-11,Canada East U19,WJAC-19,5,3,3,6,2,,62534
2010-11,Frölunda HC,SHL,47,3,17,20,24,-17,10018
2010-11,Sweden (all),International,4,0,1,1,8,2,10018
2010-11,Frölunda HC,ET,8,3,3,6,8,,10018
2011-12,Sarnia Sting,OHL,42,31,38,69,30,15,21228
2011-12,Russia U20,WJC-20,7,0,9,9,6,4,21228
2011-12,Russian Selects,Jr Super Series,1,0,2,2,0,2,21228
2011-12,Everett Silvertips,WHL,46,9,22,31,31,0,41768
2011-12,Canada U20,WJC-20,6,0,3,3,0,6,41768
2011-12,Canada,WC,6,0,0,0,0,1,41768
2011-12,Sarnia Sting,OHL,2,0,0,0,0,-4,74611
2011-12,USA U18,Hlinka Memorial,4,3,1,4,12,0,74611
2011-12,Edmonton Oil Kings,WHL,58,12,24,36,38,23,41183
2011-12,Edmonton Oil Kings,M-Cup,4,1,1,2,0,-5,41183
2011-12,Canada U18,Hlinka Memorial,5,0,0,0,6,-2,41183
2011-12,Moose Jaw Warriors,WHL,18,3,15,18,2,6,41184
2011-12,Canada U18,Hlinka Memorial,5,1,3,4,2,3,41184
2011-12,Rögle BK J18,J18 Elit,1,1,3,4,2,7,34882
2011-12,Rögle BK J20,SuperElit,28,5,12,17,16,25,34882
2011-12,Rögle BK,Allsvenskan,20,1,3,4,12,-1,34882
2011-12,Sweden U18,WJC-18,6,0,4,4,4,-1,34882
2011-12,Sweden U18 (all),International-Jr,14,0,5,5,6,3,34882
2011-12,Sweden U19,WJAC-19,4,0,0,0,2,,34882
2011-12,Red Deer Rebels,WHL,69,20,37,57,67,-6,53542
2011-12,Canada U18,WJC-18,7,5,7,12,20,2,53542
2011-12,Canada U18,Hlinka Memorial,5,2,1,3,2,4,53542
2011-12,Portland Winterhawks,WHL,72,11,48,59,79,14,59741
2011-12,Canada U18,Hlinka Memorial,5,2,1,3,4,3,59741
2011-12,USNTDP Juniors,USHL,22,4,14,18,35,8,90349
2011-12,U.S. National U18 Team,USDP,32,5,9,14,36,,90349
2011-12,USA U18,WJC-18,6,1,2,3,8,5,90349
2011-12,USA U20,WJC-20,6,0,2,2,0,-1,90349
2011-12,Peterborough Petes,OHL,26,5,13,18,17,-7,84723
2011-12,Canada U18,Hlinka Memorial,5,0,5,5,0,2,84723
2011-12,Leksands IF J18,J18 Elit,1,0,2,2,0,2,29626
2011-12,Leksands IF J20,SuperElit,6,0,1,1,2,0,29626
2011-12,Leksands IF,Allsvenskan,43,8,9,17,33,3,29626
2011-12,Sweden U18,WJC-18,6,5,2,7,6,-1,29626
2011-12,Sweden U18 (all),International-Jr,16,10,5,15,12,8,29626
2011-12,Sweden U20,WJC-20,6,0,1,1,2,-1,29626
2011-12,Sweden U20 (all),International-Jr,11,5,4,9,4,1,29626
2011-12,Sweden U18,Hlinka Memorial,5,4,1,5,0,0,29626
2011-12,Québec Remparts,QMJHL,59,40,45,85,12,35,42435
2011-12,Russia U20,WJC-20,6,2,3,5,0,2,42435
2011-12,Russia U18,Hlinka Memorial,5,0,4,4,0,0,42435
2011-12,Russian Selects,Jr Super Series,1,1,2,3,0,2,42435
2011-12,Kitchener Rangers,OHL,62,29,37,66,47,19,98300
2011-12,Czech Republic U20,WJC-20,6,2,0,2,4,-3,98300
2011-12,Czech Republic U20 (all),International-Jr,8,2,0,2,8,-3,98300
2011-12,Dubuque Fighting Saints,USHL,49,24,31,55,69,17,59843
2011-12,Latvia U20,WJC-20,6,2,0,2,6,-6,59843
2011-12,Latvia U20 (all),International-Jr,8,2,1,3,6,,59843
2011-12,Ottawa 67's,OHL,64,17,43,60,14,21,45584
2011-12,Plymouth Whalers,OHL,49,9,18,27,141,17,98663
2011-12,Canada U18,Hlinka Memorial,5,1,2,3,6,2,98663
2011-12,HC Slavia Praha,Czech,38,12,13,25,22,9,56038
2011-12,HC Slovan Ústečtí Lvi,Czech2,0,0,0,0,0,,56038
2011-12,Czech Republic U20,WJC-20,6,3,2,5,0,2,56038
2011-12,Czech Republic U20 (all),International-Jr,8,4,3,7,2,2,56038
2011-12,HC Slavia Praha,ET,4,0,0,0,2,,56038
2011-12,Jokerit U20,Jr. A SM-liiga,11,12,8,20,4,13,44567
2011-12,Jokerit,Liiga,40,11,7,18,6,-5,44567
2011-12,Kiekko-Vantaa,Mestis,3,1,2,3,0,2,44567
2011-12,Finland U18,WJC-18,6,2,6,8,2,2,44567
2011-12,Finland U18 (all),International-Jr,9,10,8,18,8,6,44567
2011-12,Finland U20 (all),International-Jr,2,0,0,0,0,,44567
2011-12,Jokerit,ET,4,1,0,1,0,,44567
2011-12,Finland U18,Hlinka Memorial,5,4,6,10,4,4,44567
2011-12,Oshawa Generals,OHL,64,21,32,53,101,8,76690
2011-12,Canada U18,WJC-18,7,2,5,7,4,3,76690
2011-12,Canada U18,Hlinka Memorial,5,2,1,3,0,1,76690
2011-12,Stanstead College,CAHS,41,31,26,57,22,,146518
2011-12,Stanstead College,MPHL,13,19,11,30,12,,146518
2011-12,London Knights,OHL,58,5,27,32,25,25,43543
2011-12,Finland U20,WJC-20,1,0,0,0,0,-2,43543
2011-12,Finland U20 (all),International-Jr,7,0,3,3,0,,43543
2011-12,London Knights,M-Cup,4,0,0,0,0,0,43543
2011-12,Dubuque Fighting Saints,USHL,53,11,16,27,84,0,76333
2011-12,Canada U18,Hlinka Memorial,5,0,0,0,2,0,76333
2011-12,Sioux City Musketeers,USHL,9,3,3,6,9,-4,50291
2011-12,Green Bay Gamblers,USHL,46,7,28,35,20,15,50291
2011-12,USA U19,WJAC-19,5,0,1,1,4,,50291
2011-12,Belleville Bulls,OHL,68,28,40,68,68,4,76290
2011-12,Canada U18,WJC-18,7,3,1,4,8,4,76290
2011-12,Canada U18,Hlinka Memorial,5,1,3,4,2,3,76290
2011-12,MODO Hockey J18,J18 Elit,3,4,1,5,8,2,33217
2011-12,MODO Hockey J20,SuperElit,16,4,5,9,22,2,33217
2011-12,MODO Hockey,SHL,15,0,2,2,12,-7,33217
2011-12,Edmonton Oil Kings,WHL,28,7,16,23,42,18,33217
2011-12,Edmonton Oil Kings,M-Cup,4,2,3,5,8,1,33217
2011-12,USNTDP Juniors,USHL,24,3,9,12,12,5,90352
2011-12,U.S. National U18 Team,USDP,60,4,19,23,36,,90352
2011-12,USA U18,WJC-18,6,0,1,1,4,10,90352
2011-12,USNTDP Juniors,USHL,18,6,4,10,93,4,77561
2011-12,U.S. National U18 Team,USDP,46,15,17,32,166,,77561
2011-12,Barrie Colts,OHL,60,37,54,91,37,21,75951
2011-12,Canada U20,WJC-20,6,1,5,6,6,1,75951
2011-12,Edmonton Oil Kings,WHL,66,16,9,25,131,5,48462
2011-12,Edmonton Oil Kings,M-Cup,4,0,0,0,7,-2,48462
2011-12,Frölunda HC J18,J18 Allsvenskan,1,1,1,2,0,0,16836
2011-12,Frölunda HC J20,SuperElit,21,9,8,17,18,5,16836
2011-12,Frölunda HC,SHL,41,0,0,0,2,-8,16836
2011-12,Sweden U18,WJC-18,6,4,5,9,14,1,16836
2011-12,Sweden U18 (all),International-Jr,16,11,14,25,22,8,16836
2011-12,Sweden U20,WJC-20,6,4,3,7,0,2,16836
2011-12,Sweden U20 (all),International-Jr,14,8,9,17,6,1,16836
2011-12,Frölunda HC,ET,1,1,0,1,0,,16836
2011-12,Sweden U18,Hlinka Memorial,5,3,4,7,0,0,16836
2011-12,Kärpät U20,Jr. A SM-liiga,4,3,4,7,2,2,45222
2011-12,Kärpät,Liiga,35,0,3,3,12,-3,45222
2011-12,Finland U18,WJC-18,7,1,5,6,4,2,45222
2011-12,Finland U18 (all),International-Jr,4,2,3,5,2,3,45222
2011-12,Finland U20,WJC-20,7,1,3,4,4,3,45222
2011-12,Finland U20 (all),International-Jr,12,2,5,7,4,,45222
2011-12,Kärpät,ET,5,0,1,1,4,,45222
2011-12,Finland U18,Hlinka Memorial,5,2,3,5,2,3,45222
2011-12,Guelph Storm,OHL,61,10,38,48,58,-13,82316
2011-12,USNTDP Juniors,USHL,18,4,9,13,18,-5,90347
2011-12,U.S. National U18 Team,USDP,54,22,26,48,38,,90347
2011-12,USA U18,WJC-18,6,4,5,9,2,8,90347
2011-12,Djurgårdens IF J20,SuperElit,6,4,2,6,0,7,16835
2011-12,Djurgårdens IF,SHL,47,8,7,15,6,-3,16835
2011-12,Sweden U19 (all),International-Jr,4,2,3,5,0,0,16835
2011-12,Sweden U20 (all),International-Jr,8,2,0,2,2,1,16835
2011-12,Djurgårdens IF,ET,5,0,2,2,0,,16835
2011-12,Univ. of Michigan,NCAA,40,11,15,26,18,23,62746
2011-12,Saskatoon Blades,WHL,70,28,31,59,165,15,48665
2011-12,Brampton Battalion,OHL,66,7,27,34,38,4,88064
2011-12,Plymouth Whalers,OHL,57,29,28,57,111,6,45566
2011-12,USNTDP Juniors,USHL,24,0,2,2,55,0,94254
2011-12,U.S. National U18 Team,USDP,60,3,7,10,113,,94254
2011-12,USA U18,WJC-18,6,0,0,0,0,3,94254
2011-12,MODO Hockey J18,J18 Elit,1,1,0,1,2,0,27493
2011-12,MODO Hockey J18,J18 Allsvenskan,0,0,0,0,0,,27493
2011-12,MODO Hockey J20,SuperElit,34,7,22,29,101,2,27493
2011-12,MODO Hockey,SHL,20,0,1,1,8,2,27493
2011-12,Sweden U18,WJC-18,6,0,1,1,2,-1,27493
2011-12,Sweden U18 (all),International-Jr,21,1,8,9,8,4,27493
2011-12,Sweden U18,Hlinka Memorial,5,0,4,4,0,0,27493
2011-12,Sweden U19,WJAC-19,4,0,1,1,2,,27493
2011-12,Univ. of Wisconsin,NCAA,26,3,9,12,12,3,45419
2011-12,Baie-Comeau Drakkar,QMJHL,56,21,23,44,60,-2,45156
2011-12,Guelph Storm,OHL,33,12,7,19,25,-2,76486
2011-12,Rouyn-Noranda Huskies,QMJHL,52,9,29,38,59,-8,76329
2011-12,Halifax Mooseheads,QMJHL,34,16,13,29,41,-9,56033
2011-12,Czech Republic U19 (all),International-Jr,3,2,0,2,4,0,56033
2011-12,Kelowna Rockets,WHL,58,26,15,41,62,-14,48393
2011-12,Saskatoon Blades,WHL,66,18,36,54,103,-4,45529
2011-12,Shattuck St. Mary's Midget Prep,USHS-Prep,51,24,64,88,63,,108347
2011-12,Latvia U18,WJC-18,6,2,2,4,6,-6,108347
2011-12,Latvia U18 (all),International-Jr,8,4,3,7,6,,108347
2011-12,Latvia U20,WJC-20,6,1,2,3,2,-5,108347
2011-12,Latvia U20 (all),International-Jr,10,1,4,5,6,,108347
2011-12,Phillips Exeter Academy,USHS-Prep,29,32,36,68,20,,131064
2011-12,Prince Albert Raiders,WHL,71,32,24,56,59,-9,56825
2011-12,Canada U18,WJC-18,7,1,1,2,4,0,56825
2011-12,London Knights,OHL,65,11,23,34,20,25,92677
2011-12,London Knights,M-Cup,4,0,1,1,0,1,92677
2011-12,St. John's Prep,USHS-Prep,24,32,28,60,23,,149169
2011-12,U.S. National U18 Team,USDP,2,0,0,0,2,,149169
2011-12,USA U18,Hlinka Memorial,4,0,0,0,6,1,149169
2011-12,Rimouski Océanic,QMJHL,68,34,47,81,132,23,37446
2011-12,Vancouver Giants,WHL,72,40,24,64,80,15,44271
2011-12,Kent School,USHS-Prep,26,7,32,39,2,,131061
2011-12,Indiana Ice,USHL,13,2,8,10,2,0,131061
2011-12,USA U18,Hlinka Memorial,4,1,3,4,0,5,131061
2011-12,Kelowna Rockets,WHL,56,7,30,37,80,5,55867
2011-12,Canada U18,WJC-18,7,0,2,2,8,7,55867
2011-12,Whitby Fury,OJHL,41,29,29,58,26,,149937
2011-12,Canada East U19,WJAC-19,4,2,4,6,0,,149937
2011-12,Prince George Spruce Kings,BCHL,54,29,50,79,69,,93577
2011-12,Canada West U19,WJAC-19,5,0,0,0,14,,93577
2011-12,Kamloops Blazers,WHL,71,36,35,71,40,27,48990
2011-12,Erie Otters,OHL,44,2,18,20,52,-20,89694
2011-12,Canada U18,WJC-18,7,0,0,0,8,2,89694
2011-12,Canada U18,Hlinka Memorial,5,0,0,0,6,3,89694
2011-12,South Shore Kings,EJHL,45,48,43,91,52,,121865
2011-12,Team EJHL,JCWC,3,3,0,3,0,0,121865
2011-12,Brother Rice High,USHS-MI,29,42,48,90,16,50,183505
2011-12,Shattuck St. Mary's Midget Prep,USHS-Prep,57,11,30,41,36,,106297
2011-12,Guelph Storm,OHL,67,30,29,59,110,-10,91265
2011-12,Canada U18,WJC-18,7,0,0,0,4,1,91265
2011-12,Guelph Storm,OHL,43,13,35,48,46,4,41755
2011-12,Switzerland U20,WJC-20,6,2,2,4,6,1,41755
2011-12,Switzerland U20 (all),International-Jr,13,6,3,9,14,,41755
2011-12,Prince George Cougars,WHL,71,18,38,56,56,-12,51708
2011-12,Canada U18,WJC-18,7,0,7,7,2,7,51708
2011-12,Saginaw Spirit,OHL,65,3,11,14,76,-4,83357
2011-12,Jokerit U20,Jr. A SM-liiga,48,21,30,51,16,24,50019
2011-12,Kiekko-Vantaa,Mestis,2,0,0,0,0,1,50019
2011-12,Finland U18,WJC-18,7,0,6,6,2,4,50019
2011-12,Finland U18 (all),International-Jr,15,2,7,9,18,3,50019
2011-12,Finland U18,Hlinka Memorial,5,1,0,1,14,-3,50019
2011-12,Regina Pats,WHL,55,22,20,42,24,-1,60726
2011-12,Union College,NCAA,41,5,17,22,20,18,122787
2011-12,Noble & Greenough School,USHS-Prep,27,28,27,55,13,,178940
2011-12,Cape Cod Whalers U18,MHSL U18,32,21,28,49,-,,178940
2011-12,Skellefteå AIK J18,J18 Elit,22,13,23,36,78,30,41621
2011-12,Skellefteå AIK J18,J18 Allsvenskan,17,8,9,17,51,7,41621
2011-12,Skellefteå AIK J20,SuperElit,2,1,0,1,0,1,41621
2011-12,Owen Sound Attack,OHL,28,12,11,23,4,-2,92684
2011-12,,,,,,,,,92684
2011-12,Canada U18,Hlinka Memorial,5,1,4,5,0,3,92684
2011-12,Victoria Royals,WHL,72,21,25,46,62,-29,59554
2011-12,USNTDP Juniors,USHL,24,1,10,11,6,8,90350
2011-12,U.S. National U18 Team,USDP,60,3,20,23,22,,90350
2011-12,USA U18,WJC-18,6,1,0,1,2,5,90350
2011-12,Fort McMurray Oil Barons,AJHL,53,9,33,42,65,,89411
2011-12,Fort McMurray Oil Barons,JCWC,3,0,2,2,2,3,89411
2011-12,Canada West U19,WJAC-19,5,0,0,0,2,,89411
2011-12,Moncton Wildcats,QMJHL,61,9,18,27,74,-7,56053
2011-12,Portland Winterhawks,WHL,65,28,30,58,82,16,89181
2011-12,Windsor Spitfires,OHL,68,18,20,38,44,-5,94248
2011-12,Belleville Bulls,OHL,50,23,13,36,25,-5,103517
2011-12,Russia U18,WJC-18,6,1,4,5,8,3,103517
2011-12,Russia U18,Hlinka Memorial,5,0,0,0,2,0,103517
2011-12,Kitchener Rangers,OHL,24,9,5,14,10,2,76687
2011-12,Canada U18,Hlinka Memorial,3,0,0,0,2,0,76687
2011-12,Djurgårdens IF J20,SuperElit,21,3,11,14,14,3,15372
2011-12,Djurgårdens IF,SHL,41,3,4,7,16,-3,15372
2011-12,Sweden U20 (all),International-Jr,3,0,1,1,8,0,15372
2011-12,Windsor Spitfires,OHL,68,22,30,52,55,1,45975
2011-12,London Knights,OHL,64,12,10,22,34,17,95853
2011-12,London Knights,M-Cup,2,1,0,1,2,1,95853
2011-12,Kitchener Rangers,OHL,67,11,31,42,137,21,44664
2011-12,Lincoln Stars,USHL,59,54,50,104,50,44,121841
2011-12,Noble & Greenough School,USHS-Prep,26,26,30,56,28,,190084
2011-12,Cape Cod Whalers U18,MHSL U18,30,19,26,45,-,,190084
2011-12,Frölunda HC J18,J18 Elit,1,0,1,1,4,0,33395
2011-12,Frölunda HC J18,J18 Allsvenskan,3,3,6,9,4,6,33395
2011-12,Frölunda HC J20,SuperElit,47,14,19,33,70,-4,33395
2011-12,Sweden U18,WJC-18,6,1,2,3,2,2,33395
2011-12,Sweden U18 (all),International-Jr,21,6,5,11,18,3,33395
2011-12,Sweden U18,Hlinka Memorial,5,2,1,3,0,0,33395
2011-12,Sweden U19,WJAC-19,4,1,0,1,6,,33395
2011-12,USNTDP Juniors,USHL,21,6,5,11,6,11,90344
2011-12,U.S. National U18 Team,USDP,55,11,10,21,22,,90344
2011-12,USA U18,WJC-18,6,1,0,1,0,0,90344
2011-12,Blainville-Boisbriand Armada,QMJHL,63,31,17,48,88,1,128521
2011-12,Okotoks Oilers,AJHL,47,3,7,10,223,,44972
2011-12,Canada West U19,WJAC-19,5,0,0,0,2,,44972
2011-12,Cape Breton Screaming Eagles,QMJHL,65,2,8,10,99,-3,88664
2011-12,Owen Sound Attack,OHL,68,21,39,60,51,9,122937
2011-12,Canada U18,WJC-18,7,2,3,5,2,-1,122937
2011-12,Canada U18,Hlinka Memorial,5,0,0,0,2,3,122937
2011-12,Vancouver Giants,WHL,72,9,15,24,22,29,88617
2011-12,Noble & Greenough School,USHS-Prep,24,6,12,18,10,,177682
2011-12,Cape Cod Whalers U18,MHSL U18,33,5,15,20,-,,177682
2011-12,Univ. of Notre Dame,NCAA,36,7,10,17,34,5,58561
2011-12,Chicoutimi Saguenéens,QMJHL,68,8,21,29,95,2,76156
2011-12,Acadie-Bathurst Titan,QMJHL,63,16,31,47,35,5,88659
2011-12,London Knights,OHL,63,22,15,37,22,22,86009
2011-12,London Knights,M-Cup,3,1,1,2,0,1,86009
2011-12,Canada U18,Hlinka Memorial,5,3,1,4,0,1,86009
2011-12,Brynäs IF J18,J18 Elit,19,2,7,9,109,25,38937
2011-12,Brynäs IF J18,J18 Allsvenskan,16,1,5,6,49,8,38937
2011-12,Brynäs IF J20,SuperElit,14,1,3,4,24,2,38937
2011-12,Shattuck St. Mary's Midget Prep,USHS-Prep,50,22,43,65,20,,94246
2011-12,Atlanty Mytishchi,MHL,47,11,11,22,16,1,160093
2011-12,Russia U18,WJC-18,6,1,2,3,12,0,160093
2011-12,Russia U18 (all),International-Jr,6,1,2,3,12,0,160093
2011-12,Mississauga St. Michael's Majors,OHL,68,6,13,19,64,-5,69391
2011-12,Everett Silvertips,WHL,62,6,12,18,95,-27,57161
2011-12,Portland Winterhawks,WHL,72,13,24,37,36,10,45615
2011-12,HIFK U18,Jr. B SM-sarja Q,1,0,0,0,4,,43289
2011-12,HIFK U18,Jr. B SM-sarja,1,0,1,1,4,,43289
2011-12,HIFK U20,Jr. A SM-liiga,38,7,11,18,44,7,43289
2011-12,HIFK,Liiga,8,0,0,0,2,-1,43289
2011-12,Finland U18,WJC-18,7,0,4,4,8,0,43289
2011-12,Finland U18 (all),International-Jr,15,1,6,7,22,9,43289
2011-12,Finland U18,Hlinka Memorial,5,0,1,1,6,5,43289
2011-12,Färjestad BK J18,J18 Elit,4,0,1,1,0,6,30181
2011-12,Färjestad BK J18,J18 Allsvenskan,6,3,5,8,0,2,30181
2011-12,Färjestad BK J20,SuperElit,49,12,24,36,56,5,30181
2011-12,Sweden U18,WJC-18,6,0,3,3,0,0,30181
2011-12,Sweden U18 (all),International-Jr,21,2,8,10,14,7,30181
2011-12,Sweden U18,Hlinka Memorial,5,1,1,2,0,0,30181
2011-12,Sweden U19,WJAC-19,4,0,1,1,2,,30181
2011-12,Chicago Steel,USHL,60,3,27,30,12,6,97621
2011-12,USA U18,Hlinka Memorial,4,0,0,0,0,0,97621
2011-12,CSKA Moskva,KHL,15,1,1,2,4,-1,93769
2011-12,Krasnaya Armiya Moskva,MHL,15,9,17,26,47,13,93769
2011-12,Chicoutimi Saguenéens,QMJHL,59,25,41,66,50,28,76324
2011-12,QMJHL All-Stars,Jr Super Series,2,1,1,2,0,1,76324
2011-12,Canada U18,Hlinka Memorial,5,5,4,9,0,3,76324
2011-12,Univ. of Denver,NCAA,43,11,27,38,35,13,46961
2011-12,Québec Remparts,QMJHL,60,6,19,25,28,9,88706
2011-12,Kimball Union Academy,USHS-Prep,31,1,13,14,-,,177665
2011-12,Team North,USHS-MN,21,9,14,23,28,,122004
2011-12,Duluth East High,USHS-MN,25,27,34,61,28,,122004
2011-12,Fargo Force,USHL,4,1,0,1,2,-1,122004
2011-12,Duluth East High,MN State,3,3,3,6,0,1,122004
2011-12,Fargo Force,USHL,55,6,18,24,92,16,45698
2011-12,USA U19,WJAC-19,5,0,3,3,8,,45698
2011-12,Luleå HF J20,SuperElit,6,2,1,3,8,5,13319
2011-12,Luleå HF,SHL,46,3,4,7,8,6,13319
2011-12,Sweden U20 (all),International-Jr,3,0,1,1,0,0,13319
2011-12,Sweden (all),International,4,1,2,3,4,2,13319
2011-12,Luleå HF,ET,6,0,0,0,2,,13319
2011-12,Univ. of Wisconsin,NCAA,34,5,5,10,67,-3,45678
2011-12,London Knights,OHL,68,45,40,85,49,24,45606
2011-12,London Knights,M-Cup,4,1,2,3,4,-3,45606
2011-12,Windsor Spitfires,OHL,68,15,21,36,81,-6,82516
2011-12,Victoria Royals,WHL,71,23,39,62,70,-2,90312
2011-12,Seattle Thunderbirds,WHL,58,14,12,26,83,-16,51702
2011-12,Canada U18,WJC-18,7,0,1,1,10,-1,51702
2011-12,Swift Current Broncos,WHL,71,17,33,50,49,3,65272
2011-12,Indiana Ice,USHL,54,14,34,48,36,-1,122785
2011-12,USNTDP Juniors,USHL,21,1,4,5,30,1,90348
2011-12,U.S. National U18 Team,USDP,57,8,13,21,46,,90348
2011-12,USA U18,WJC-18,6,2,2,4,2,4,90348
2011-12,St. Sebastian's School,USHS-Prep,26,20,34,54,-,,121936
2011-12,Cape Cod Whalers U18,MHSL U18,8,5,6,11,4,,121936
2011-12,USNTDP Juniors,USHL,7,3,2,5,0,0,121936
2011-12,U.S. National U18 Team,USDP,14,4,6,10,2,,121936
2011-12,USA U18,WJC-18,6,1,3,4,0,6,121936
2011-12,USA U18,Hlinka Memorial,4,2,3,5,2,2,121936
2011-12,Saginaw Spirit,OHL,60,25,29,54,93,13,45562
2011-12,Lincoln Stars,USHL,59,2,17,19,237,7,75053
2011-12,Merritt Centennials,BCHL,52,5,18,23,26,,93550
2011-12,Canada West U19,WJAC-19,5,0,0,0,0,,93550
2011-12,Herning Blue Fox,Denmark,33,21,16,37,6,,32417
2011-12,Denmark U20,WJC-20,6,1,3,4,0,-11,32417
2011-12,Denmark U20 (all),International-Jr,17,6,8,14,2,,32417
2011-12,Herning Blue Fox,Danish Cup,5,2,2,4,8,,32417
2011-12,Peterborough Petes,OHL,47,0,8,8,96,-4,45414
2011-12,Oshawa Generals,OHL,10,2,0,2,12,-1,91624
2011-12,Plymouth Whalers,OHL,50,3,11,14,95,-1,91624
2011-12,USA U18,Hlinka Memorial,4,0,0,0,4,-3,91624
2011-12,Kemptville 73s,CCHL,35,7,20,27,25,,78150
2011-12,Nepean Raiders,CCHL,22,4,12,16,6,,78150
2011-12,Nepean Raiders,Fred Page Cup,5,0,5,5,0,,78150
2011-12,Canada East U19,WJAC-19,4,1,2,3,2,,78150
2011-12,Blues U18,Jr. B SM-sarja Q,7,3,9,12,32,,42366
2011-12,Blues U18,Jr. B SM-sarja,0,0,0,0,0,,42366
2011-12,Blues U20,Jr. A SM-liiga,39,8,15,23,14,-1,42366
2011-12,Finland U18,WJC-18,7,0,2,2,4,1,42366
2011-12,Finland U18 (all),International-Jr,12,1,7,8,2,11,42366
2011-12,Finland U18,Hlinka Memorial,5,0,0,0,0,0,42366
2011-12,Moose Jaw Warriors,WHL,66,7,24,31,45,19,94342
2011-12,Coquitlam Express,BCHL,51,25,44,69,24,,59968
2011-12,Canada West U19,WJAC-19,5,2,1,3,2,,59968
2011-12,Sault Ste. Marie Greyhounds,OHL,54,8,20,28,79,9,61228
2011-12,Rögle BK J18,J18 Elit,5,6,4,10,0,8,39009
2011-12,Rögle BK J18,J18 Allsvenskan,2,0,2,2,0,-3,39009
2011-12,Rögle BK J20,SuperElit,44,14,24,38,28,6,39009
2011-12,Sweden U18 (all),International-Jr,4,1,0,1,0,0,39009
2011-12,Cornell Univ.,NCAA,35,6,13,19,61,1,37867
2011-12,MODO Hockey J20,SuperElit,32,9,19,28,16,-1,32070
2011-12,MODO Hockey,SHL,19,0,2,2,0,-1,32070
2011-12,Sweden U19 (all),International-Jr,7,2,6,8,2,2,32070
2011-12,Niagara IceDogs,OHL,68,4,37,41,36,25,92681
2011-12,Erie Otters,OHL,68,25,28,53,14,-72,97341
2011-12,London Knights,OHL,63,17,31,48,120,10,75471
2011-12,London Knights,M-Cup,4,2,1,3,8,0,75471
2011-12,Bern U20,Elite Jr. A,13,7,15,22,22,,85327
2011-12,SC Bern,NLA,31,8,8,16,10,4,85327
2011-12,Switzerland U18 (all),International-Jr,6,5,1,6,4,,85327
2011-12,Switzerland U20,WJC-20,6,2,2,4,4,0,85327
2011-12,Switzerland U20 (all),International-Jr,11,5,5,10,4,,85327
2011-12,Switzerland U18,Hlinka Memorial,4,1,0,1,2,0,85327
2011-12,Saskatoon Blades,WHL,67,15,17,32,64,-12,50187
2011-12,Owen Sound Attack,OHL,64,3,16,19,77,-2,96063
2011-12,Owen Sound Attack,OHL,68,17,14,31,72,4,99041
2011-12,Huddinge IK J18,J18 Elit,2,0,0,0,0,-3,37054
2011-12,Huddinge IK J18,J18 Allsvenskan,3,0,1,1,0,1,37054
2011-12,Huddinge IK J20,SuperElit,47,3,12,15,12,1,37054
2011-12,Sweden U18 (all),International-Jr,7,0,3,3,0,1,37054
2011-12,Swift Current Broncos,WHL,66,30,23,53,12,2,103707
2011-12,USNTDP Juniors,USHL,24,5,6,11,59,0,89847
2011-12,U.S. National U18 Team,USDP,60,21,15,36,85,,89847
2011-12,USA U18,WJC-18,6,1,2,3,2,2,89847
2011-12,Sioux City Musketeers,USHL,58,0,8,8,53,-13,122694
2011-12,Waterloo Black Hawks,USHL,55,20,24,44,56,11,91243
2011-12,USA U19,WJAC-19,5,1,3,4,4,,91243
2011-12,USA U18,Hlinka Memorial,4,2,2,4,2,1,91243
2011-12,Toronto Lakeshore Patriots,OJHL,45,10,19,29,32,,117750
2011-12,Gatineau Olympiques,QMJHL,50,20,44,64,30,14,56035
2011-12,Czech Republic U20,WJC-20,5,0,2,2,4,-1,56035
2011-12,Czech Republic U20 (all),International-Jr,7,1,2,3,4,-1,56035
2011-12,Färjestad BK J20,SuperElit,28,17,18,35,6,11,27258
2011-12,Färjestad BK,SHL,18,2,3,5,0,-2,27258
2011-12,Sweden U19 (all),International-Jr,7,1,4,5,2,3,27258
2011-12,Shawinigan Cataractes,QMJHL,66,40,36,76,50,42,58562
2011-12,Shawinigan Cataractes,M-Cup,6,5,4,9,0,4,58562
2011-12,Russian Selects,Jr Super Series,1,0,0,0,0,1,58562
2011-12,Rimouski Océanic,QMJHL,67,23,11,34,75,-11,45149
2011-12,Spruce Grove Saints,AJHL,44,4,14,18,87,,29261
2011-12,Jokerit U20,Jr. A SM-liiga,41,3,7,10,98,15,45347
2011-12,Kiekko-Vantaa,Mestis,5,0,3,3,8,2,45347
2011-12,Finland U20 (all),International-Jr,8,0,0,0,16,,45347
2011-12,Jokerit,ET,2,0,0,0,4,,45347
2011-12,Victoria Grizzlies,BCHL,26,17,25,42,18,,48361
2011-12,Canada West U19,WJAC-19,5,0,1,1,0,,48361
2011-12,Shattuck St. Mary's Midget Prep,USHS-Prep,55,38,40,78,20,,106299
2011-12,Owen Sound Attack,OHL,45,15,22,37,18,-3,70442
2011-12,Belarus U18,WJC-18 D1B,5,1,3,4,4,5,70442
2011-12,Lincoln Stars,USHL,56,9,25,34,27,36,90101
2011-12,Sault Ste. Marie Greyhounds,OHL,63,3,13,16,36,-14,91686
2011-12,MHK Zelenograd,MHL B,7,0,0,0,10,2,121902
2011-12,UMass-Lowell,NCAA,0,0,0,0,0,,121902
2011-12,Grand Rapids High,USHS-MN,25,11,29,40,17,,180081
2011-12,Team North,USHS-MN,21,4,7,11,4,,180081
2011-12,Omaha Lancers,USHL,10,0,1,1,2,0,180081
2011-12,Muskegon Lumberjacks,USHL,58,11,22,33,50,-18,84766
2011-12,Calgary Hitmen,WHL,58,3,11,14,63,7,49967
2011-12,Edina High,USHS-MN,24,12,8,20,30,,150969
2011-12,Team Southwest,USHS-MN,20,7,13,20,12,,150969
2011-12,Edina High,MN State,2,0,1,1,4,-1,150969
2011-12,USA U18,Hlinka Memorial,4,1,2,3,0,-2,150969
2011-12,Malden Catholic High,USHS-Prep,22,27,37,64,-,,121930
2011-12,Kamloops Blazers,WHL,72,35,50,85,51,31,26388
2011-12,Belleville Bulls,OHL,68,6,20,26,59,-1,45403
2011-12,Linköping HC J20,SuperElit,38,5,4,9,24,9,23547
2011-12,Linköping HC,SHL,1,0,0,0,0,0,23547
2011-12,Sweden U19 (all),International-Jr,3,0,0,0,2,0,23547
2011-12,Linköping HC,ET,7,0,0,0,4,,23547
2011-12,Brynäs IF J18,J18 Elit,1,1,1,2,0,2,33201
2011-12,Brynäs IF J18,J18 Allsvenskan,6,4,7,11,4,7,33201
2011-12,Brynäs IF J20,SuperElit,40,3,21,24,22,11,33201
2011-12,Brynäs IF,SHL,1,0,0,0,0,0,33201
2011-12,Sweden U18,WJC-18,6,1,2,3,2,3,33201
2011-12,Sweden U18 (all),International-Jr,14,3,3,6,10,8,33201
2011-12,Mora IK J20,SuperElit,11,3,4,7,2,3,28992
2011-12,Mora IK,Allsvenskan,47,2,1,3,14,8,28992
2011-12,Sweden U19 (all),International-Jr,7,2,3,5,4,4,28992
2011-12,Calgary Hitmen,WHL,55,5,18,23,124,9,45481
2011-12,Cornell Univ.,NCAA,34,7,10,17,20,2,51926
2011-12,Sweden U20 (all),International-Jr,5,0,0,0,0,0,51926
2011-12,Östersunds IK J18,J18 Elit,29,9,17,26,94,12,40853
2011-12,Östersunds IK,Division 1,20,3,7,10,18,7,40853
2011-12,MHK Spartak Moskva,MHL,18,1,1,2,24,4,123080
2011-12,Russia U18,Hlinka Memorial,5,0,0,0,12,0,123080
2011-12,Russia U19,WJAC-19,4,0,0,0,2,,123080
2011-12,CSKA Moskva,KHL,15,2,1,3,0,-1,75169
2011-12,Krasnaya Armiya Moskva,MHL,34,30,46,76,26,23,75169
2011-12,Russia U20,WJC-20,7,3,6,9,0,5,75169
2011-12,Russian Selects,Jr Super Series,6,3,4,7,0,5,75169
2011-12,Duluth Marshall School,USHS-MN,30,47,36,83,32,,118099
2011-12,Team North,USHS-MN,16,4,2,6,22,,118099
2011-12,Duluth Marshall School,MN State,2,3,1,4,0,,118099
2011-12,Fargo Force,USHL,54,16,22,38,140,1,74775
2011-12,Brandon Wheat Kings,WHL,32,6,13,19,23,-10,84741
2011-12,Phillips Exeter Academy,USHS-Prep,28,39,34,73,18,,177685
2011-12,Shawinigan Cataractes,QMJHL,60,2,16,18,46,27,56049
2011-12,Shawinigan Cataractes,M-Cup,6,0,0,0,0,-2,56049
2011-12,Södertälje SK J20,SuperElit,5,0,3,3,2,0,20058
2011-12,Södertälje SK,Allsvenskan,50,3,3,6,42,-8,20058
2011-12,Univ. of Nebraska-Omaha,NCAA,35,2,3,5,8,-1,84762
2011-12,Windsor Spitfires,OHL,66,6,33,39,58,-2,45972
2012-13,Halifax Mooseheads,QMJHL,44,32,43,75,45,40,99204
2012-13,Canada U20,WJC-20,6,0,1,1,4,-1,99204
2012-13,QMJHL All-Stars,Jr Super Series,2,1,3,4,2,-2,99204
2012-13,Canada U18,Hlinka Memorial,5,5,6,11,14,8,99204
2012-13,Halifax Mooseheads,M-Cup,4,7,6,13,0,8,99204
2012-13,Tappara,Liiga,53,21,27,48,8,18,50044
2012-13,Finland U20,WJC-20,6,3,4,7,6,2,50044
2012-13,Tappara,ET,7,3,1,4,4,,50044
2012-13,Halifax Mooseheads,QMJHL,49,41,64,105,32,48,118657
2012-13,Canada U20,WJC-20,6,2,2,4,0,4,118657
2012-13,Halifax Mooseheads,M-Cup,4,1,8,9,0,6,118657
2012-13,Canada U18,Hlinka Memorial,5,0,5,5,2,3,118657
2012-13,QMJHL All-Stars,Jr Super Series,1,1,3,4,0,2,118657
2012-13,Portland Winterhawks,WHL,61,14,42,56,33,46,90355
2012-13,USA U20,WJC-20,7,1,6,7,4,8,90355
2012-13,Portland Winterhawks,M-Cup,5,2,2,4,4,6,90355
2012-13,Brynäs IF,SHL,48,11,19,30,2,1,33387
2012-13,Sweden U20,WJC-20,6,2,2,4,4,-1,33387
2012-13,Sweden U20 (all),International-Jr,12,5,4,9,6,3,33387
2012-13,Brynäs IF,ET,3,0,1,1,0,,33387
2012-13,Ottawa 67's,OHL,58,31,47,78,24,-18,85013
2012-13,OHL All-Stars,Jr Super Series,1,0,1,1,0,0,85013
2012-13,Canada U20,CAN-RUS Challenge,4,2,2,4,2,,85013
2012-13,Sault Ste. Marie Greyhounds,OHL,68,12,29,41,116,15,97352
2012-13,Canada U18,Hlinka Memorial,5,0,0,0,4,2,97352
2012-13,TPS U20,Jr. A SM-liiga,0,0,0,0,0,,43497
2012-13,TPS,Liiga,52,3,12,15,32,-7,43497
2012-13,Finland U20,WJC-20,6,2,4,6,20,5,43497
2012-13,Finland U20 (all),International-Jr,14,2,6,8,32,7,43497
2012-13,Finland (all),International,4,0,1,1,2,0,43497
2012-13,TPS,ET,7,1,2,3,18,,43497
2012-13,London Knights,OHL,67,33,28,61,29,3,117012
2012-13,London Knights,M-Cup,5,2,3,5,0,-2,117012
2012-13,Canada U18,Hlinka Memorial,5,2,2,4,6,0,117012
2012-13,Traktor Chelyabinsk,KHL,18,4,2,6,0,6,108661
2012-13,Chelmet Chelyabinsk,VHL,15,8,2,10,4,8,108661
2012-13,Belye Medvedi Chelyabinsk,MHL,9,4,4,8,0,4,108661
2012-13,Russia U18,WJC-18,6,4,3,7,0,0,108661
2012-13,Russia U20,WJC-20,6,1,1,2,25,5,108661
2012-13,Russian Selects,Jr Super Series,5,0,0,0,0,3,108661
2012-13,Rimouski Océanic,QMJHL,46,4,12,16,117,10,126391
2012-13,Canada U18,WJC-18,7,0,2,2,6,6,126391
2012-13,London Knights,OHL,64,39,48,87,71,33,95484
2012-13,OHL All-Stars,Jr Super Series,1,0,0,0,2,0,95484
2012-13,Canada U18,Hlinka Memorial,5,3,4,7,2,7,95484
2012-13,London Knights,M-Cup,5,1,2,3,6,-9,95484
2012-13,Prince Albert Raiders,WHL,70,15,32,47,91,14,62293
2012-13,Canada U18,WJC-18,7,3,4,7,4,10,62293
2012-13,Canada U18,Hlinka Memorial,5,1,8,9,14,7,62293
2012-13,Djurgårdens IF J20,SuperElit,2,1,1,2,0,2,37041
2012-13,Djurgårdens IF,Allsvenskan,46,14,18,32,14,10,37041
2012-13,Sweden U20,WJC-20,6,2,1,3,0,2,37041
2012-13,Sweden U20 (all),International-Jr,16,3,6,9,6,3,37041
2012-13,Djurgårdens IF,ET,4,0,0,0,2,,37041
2012-13,Brandon Wheat Kings,WHL,61,14,31,45,22,-7,86761
2012-13,WHL All-Stars,Jr Super Series,1,0,0,0,0,0,86761
2012-13,London Knights,OHL,63,6,19,25,54,33,108648
2012-13,London Knights,M-Cup,5,2,0,2,2,1,108648
2012-13,Russia U18,Hlinka Memorial,4,0,3,3,0,0,108648
2012-13,Russian Selects,Jr Super Series,1,0,0,0,0,1,108648
2012-13,Edmonton Oil Kings,WHL,72,38,23,61,47,25,81116
2012-13,WHL All-Stars,Jr Super Series,2,0,0,0,0,0,81116
2012-13,Canada U18,Hlinka Memorial,5,3,2,5,2,4,81116
2012-13,Everett Silvertips,WHL,63,6,25,31,57,-10,95044
2012-13,Switzerland U18,WJC-18,5,1,2,3,2,-1,95044
2012-13,Switzerland U18 (all),International-Jr,8,2,2,4,4,,95044
2012-13,Switzerland U20,WJC-20,6,0,2,2,6,7,95044
2012-13,Switzerland U20 (all),International-Jr,13,0,2,2,10,,95044
2012-13,Windsor Spitfires,OHL,68,40,47,87,94,-21,82918
2012-13,OHL All-Stars,Jr Super Series,1,0,0,0,0,0,82918
2012-13,Val-d'Or Foreurs,QMJHL,67,50,39,89,71,21,104045
2012-13,QMJHL All-Stars,Jr Super Series,2,0,1,1,0,-1,104045
2012-13,Rimouski Océanic,QMJHL,62,22,38,60,26,22,128500
2012-13,Canada U18,WJC-18,7,1,3,4,2,4,128500
2012-13,Gatineau Olympiques,QMJHL,65,32,38,70,101,0,128977
2012-13,Malmö Redhawks J18,J18 Elit,1,2,2,4,0,3,38705
2012-13,Malmö Redhawks J18,J18 Allsvenskan,2,4,2,6,2,6,38705
2012-13,Malmö Redhawks J20,SuperElit,13,3,4,7,8,-4,38705
2012-13,Malmö Redhawks,Allsvenskan,43,4,7,11,8,-2,38705
2012-13,Sweden U18,WJC-18,5,4,1,5,4,1,38705
2012-13,Sweden U18 (all),International-Jr,16,10,7,17,24,5,38705
2012-13,Sweden U20 (all),International-Jr,3,0,1,1,4,1,38705
2012-13,Sweden U18,Hlinka Memorial,5,3,3,6,16,2,38705
2012-13,Medicine Hat Tigers,WHL,64,37,49,86,44,-13,52391
2012-13,Canada U20,CAN-RUS Challenge,3,0,0,0,2,,52391
2012-13,WHL All-Stars,Jr Super Series,1,0,0,0,2,0,52391
2012-13,USNTDP Juniors,USHL,19,5,5,10,84,1,135703
2012-13,U.S. National U18 Team,USDP,59,16,21,37,182,,135703
2012-13,USA U18,WJC-18,7,3,2,5,14,0,135703
2012-13,Seattle Thunderbirds,WHL,71,19,31,50,32,-24,101581
2012-13,Canada U18,WJC-18,7,0,5,5,0,5,101581
2012-13,Canada U18,Hlinka Memorial,5,0,0,0,2,4,101581
2012-13,HC Slovan Bratislava U20,Slovakia U20,0,0,0,0,0,,94946
2012-13,HC Slovan Bratislava,KHL,37,3,4,7,26,4,94946
2012-13,Slovakia U20,WJC-20,6,4,5,9,12,-1,94946
2012-13,Slovakia U20 (all),International-Jr,4,1,4,5,4,,94946
2012-13,Slovakia,WC,5,1,1,2,2,-1,94946
2012-13,Slovakia (all),International,12,2,3,5,8,0,94946
2012-13,HC Slovan Bratislava,ET,5,1,0,1,2,,94946
2012-13,Regina Pats,WHL,72,36,40,76,20,-1,62209
2012-13,Canada U18,WJC-18,7,3,5,8,6,4,62209
2012-13,Canada U18,Hlinka Memorial,5,1,0,1,4,1,62209
2012-13,Guelph Storm,OHL,66,18,29,47,31,19,117018
2012-13,Canada U18,WJC-18,3,0,1,1,4,3,117018
2012-13,Plymouth Whalers,OHL,56,23,37,60,120,29,90345
2012-13,USA U20,WJC-20,7,2,1,3,16,4,90345
2012-13,Waterloo Black Hawks,USHL,53,11,33,44,48,35,90302
2012-13,Waterloo Black Hawks,JCWC,6,1,2,3,4,-3,90302
2012-13,Owen Sound Attack,OHL,68,8,30,38,34,35,117736
2012-13,Canada U18,WJC-18,7,0,3,3,0,8,117736
2012-13,Canada U18,Hlinka Memorial,5,0,0,0,2,1,117736
2012-13,Québec Remparts,QMJHL,68,28,44,72,67,11,90359
2012-13,USA U18,Hlinka Memorial,4,5,1,6,0,3,90359
2012-13,Leksands IF J20,SuperElit,4,1,4,5,0,2,28436
2012-13,Leksands IF,Allsvenskan,38,6,6,12,31,8,28436
2012-13,Sweden U18,WJC-18,5,1,2,3,29,0,28436
2012-13,Sweden U18 (all),International-Jr,15,5,7,12,53,2,28436
2012-13,Sweden U20,WJC-20,6,0,0,0,22,1,28436
2012-13,Sweden U20 (all),International-Jr,15,0,4,4,30,0,28436
2012-13,Sweden U18,Hlinka Memorial,5,2,2,4,20,1,28436
2012-13,USNTDP Juniors,USHL,21,7,17,24,23,12,114800
2012-13,U.S. National U18 Team,USDP,52,18,32,50,51,,114800
2012-13,USA U18,WJC-18,7,3,4,7,8,2,114800
2012-13,Baie-Comeau Drakkar,QMJHL,67,40,35,75,60,29,155382
2012-13,Russian Selects,Jr Super Series,2,1,1,2,0,1,155382
2012-13,Edina High,USHS-MN,25,15,28,43,8,,195261
2012-13,Team Southwest,USHS-MN,11,3,13,16,12,,195261
2012-13,Muskegon Lumberjacks,USHL,11,1,7,8,4,1,195261
2012-13,U.S. National U18 Team,USDP,10,1,1,2,4,,195261
2012-13,Edina High,MN State,3,3,2,5,2,5,195261
2012-13,Chicoutimi Saguenéens,QMJHL,62,25,32,57,50,0,126400
2012-13,Canada U18,WJC-18,7,4,2,6,6,2,126400
2012-13,London Knights,OHL,65,7,10,17,34,7,127847
2012-13,London Knights,M-Cup,5,0,1,1,4,1,127847
2012-13,MODO Hockey J18,J18 Allsvenskan,0,0,0,0,0,,27397
2012-13,MODO Hockey J20,SuperElit,28,11,13,24,24,8,27397
2012-13,MODO Hockey,SHL,27,0,1,1,2,-3,27397
2012-13,Sweden U18,WJC-18,5,1,3,4,12,1,27397
2012-13,Sweden U18 (all),International-Jr,19,6,10,16,53,4,27397
2012-13,Sweden U20,WJC-20,5,1,1,2,0,-1,27397
2012-13,Sweden U20 (all),International-Jr,5,1,1,2,0,-1,27397
2012-13,Sweden U18,Hlinka Memorial,4,3,2,5,35,2,27397
2012-13,USNTDP Juniors,USHL,25,0,5,5,6,6,96780
2012-13,U.S. National U18 Team,USDP,66,0,15,15,44,,96780
2012-13,USA U18,WJC-18,7,0,0,0,0,8,96780
2012-13,Portland Winterhawks,WHL,71,46,74,120,43,68,82305
2012-13,Canada U18,Hlinka Memorial,5,1,1,2,2,0,82305
2012-13,Portland Winterhawks,M-Cup,5,1,9,10,0,1,82305
2012-13,Québec Remparts,QMJHL,46,20,27,47,18,10,33472
2012-13,Sweden U20,WJC-20,6,0,0,0,2,-1,33472
2012-13,Sweden U20 (all),International-Jr,8,0,0,0,4,-1,33472
2012-13,Green Bay Gamblers,USHL,63,2,21,23,59,11,39017
2012-13,Minnetonka High,USHS-MN,27,10,25,35,14,,196704
2012-13,Team Northwest,USHS-MN,20,4,10,14,16,,196704
2012-13,USNTDP Juniors,USHL,11,1,1,2,4,7,196704
2012-13,U.S. National U18 Team,USDP,20,3,2,5,4,,196704
2012-13,USA U18,WJC-18,7,2,1,3,0,0,196704
2012-13,USA U18,Hlinka Memorial,4,0,0,0,2,-5,196704
2012-13,Owen Sound Attack,OHL,62,20,20,40,32,21,103947
2012-13,Canada U18,WJC-18,7,2,2,4,4,4,103947
2012-13,Baie-Comeau Drakkar,QMJHL,67,22,41,63,43,31,151140
2012-13,Swift Current Broncos,WHL,71,4,23,27,80,25,62233
2012-13,Canada U18,WJC-18,7,1,0,1,4,2,62233
2012-13,Linköping HC J18,J18 Elit,2,2,0,2,0,1,85666
2012-13,Linköping HC J18,J18 Allsvenskan,1,0,2,2,2,4,85666
2012-13,Linköping HC J20,SuperElit,37,5,8,13,12,18,85666
2012-13,Sweden U18 (all),International-Jr,9,1,0,1,8,0,85666
2012-13,Kitchener Rangers,OHL,57,17,19,36,34,22,116970
2012-13,USA U18,Hlinka Memorial,4,2,0,2,2,3,116970
2012-13,Kelowna Rockets,WHL,69,12,18,30,75,41,97787
2012-13,Canada U18,WJC-18,7,2,2,4,6,3,97787
2012-13,Canada U18,Hlinka Memorial,5,0,1,1,6,3,97787
2012-13,KalPa,Liiga,45,14,16,30,12,12,43584
2012-13,Finland U18,WJC-18,7,3,6,9,12,2,43584
2012-13,Finland U18 (all),International-Jr,11,5,9,14,16,6,43584
2012-13,Finland U20,WJC-20,6,3,1,4,4,5,43584
2012-13,Finland U20 (all),International-Jr,8,4,1,5,6,4,43584
2012-13,KalPa,ET,7,5,3,8,2,,43584
2012-13,Blainville-Boisbriand Armada,QMJHL,65,29,38,67,68,12,97663
2012-13,Cape Breton Screaming Eagles,QMJHL,34,16,26,42,41,-14,88662
2012-13,QMJHL All-Stars,Jr Super Series,2,0,0,0,0,-2,88662
2012-13,Guelph Storm,OHL,43,13,9,22,68,-2,125028
2012-13,Djurgårdens IF J20,SuperElit,13,1,3,4,22,2,33350
2012-13,Djurgårdens IF,Allsvenskan,31,0,1,1,8,-3,33350
2012-13,Sweden U19 (all),International-Jr,4,1,0,1,4,2,33350
2012-13,Sweden U20,WJC-20,6,0,0,0,6,0,33350
2012-13,Sweden U20 (all),International-Jr,20,1,2,3,22,3,33350
2012-13,Djurgårdens IF,ET,2,0,0,0,2,,33350
2012-13,Islanders Hockey Club,EJHL,37,12,24,36,22,,242077
2012-13,Prince Edward Island Rocket,QMJHL,18,5,8,13,12,11,128231
2012-13,Canada U18,WJC-18,7,1,0,1,6,4,128231
2012-13,Canada U18,Hlinka Memorial,5,1,1,2,4,3,128231
2012-13,Victoriaville Tigres,QMJHL,67,4,22,26,117,12,94297
2012-13,Vernon Vipers,BCHL,36,22,17,39,18,,103529
2012-13,Surrey Eagles,BCHL,16,14,12,26,8,,103529
2012-13,Surrey Eagles,Western Canada Cup,5,3,1,4,2,,103529
2012-13,Surrey Eagles,RBC Cup,5,2,4,6,4,,103529
2012-13,Univ. of New Hampshire,NCAA,38,1,5,6,10,6,121869
2012-13,Victoria Royals,WHL,70,0,7,7,159,-10,63193
2012-13,Rögle BK J18,J18 Elit,3,1,2,3,4,4,86135
2012-13,Rögle BK J18,J18 Allsvenskan,4,2,1,3,0,3,86135
2012-13,Rögle BK J20,SuperElit,39,3,20,23,47,26,86135
2012-13,Rögle BK,SHL,9,0,0,0,4,-3,86135
2012-13,Sweden U18 (all),International-Jr,6,1,1,2,4,0,86135
2012-13,Sweden U19 (all),International-Jr,4,0,3,3,2,7,86135
2012-13,Sudbury Wolves,OHL,66,21,27,48,44,-1,106161
2012-13,Canada U18,WJC-18,7,3,5,8,4,6,106161
2012-13,Sudbury Wolves,JCWC,5,1,1,2,4,0,106161
2012-13,Erie Otters,OHL,63,22,14,36,139,-31,89696
2012-13,Kelowna Rockets,WHL,64,14,13,27,135,7,56840
2012-13,Kingston Frontenacs,OHL,66,17,31,48,40,-12,125026
2012-13,Canada U18,Hlinka Memorial,5,1,0,1,4,0,125026
2012-13,USNTDP Juniors,USHL,24,11,9,20,51,13,151828
2012-13,U.S. National U18 Team,USDP,53,17,17,34,80,,151828
2012-13,USA U18,WJC-18,7,1,1,2,6,3,151828
2012-13,Severstal Cherepovets,KHL,12,1,1,2,0,-2,158906
2012-13,Almaz Cherepovets,MHL,24,8,15,23,36,-2,158906
2012-13,Russia U18,WJC-18,7,5,6,11,2,4,158906
2012-13,Russia U18,Hlinka Memorial,4,1,1,2,0,0,158906
2012-13,Russia U20,CAN-RUS Challenge,-,0,0,0,0,,158906
2012-13,Waterloo Black Hawks,USHL,59,38,55,93,49,39,118430
2012-13,Waterloo Black Hawks,JCWC,6,2,3,5,4,2,118430
2012-13,USA U19,WJAC-19,4,1,3,4,0,,118430
2012-13,Sioux City Musketeers,USHL,60,29,44,73,24,13,199870
2012-13,AIK,SHL,55,14,17,31,32,-4,16629
2012-13,Sweden (all),International,4,1,1,2,0,4,16629
2012-13,Québec Remparts,QMJHL,55,20,30,50,22,23,98665
2012-13,Canada U18,Hlinka Memorial,5,1,1,2,8,2,98665
2012-13,Owen Sound Attack,OHL,67,13,15,28,100,14,92683
2012-13,Niagara IceDogs,OHL,67,18,26,44,22,-12,116967
2012-13,Canada U18,WJC-18,7,0,4,4,4,3,116967
2012-13,Dizel Penza,VHL,21,3,6,9,12,6,117749
2012-13,Izhstal Izhevsk,VHL,16,5,8,13,4,6,117749
2012-13,Reaktor Nizhnekamsk,MHL,11,6,7,13,2,8,117749
2012-13,Russian Selects,Jr Super Series,4,0,0,0,2,-1,117749
2012-13,Saginaw Spirit,OHL,64,28,39,67,28,4,151451
2012-13,USA U18,Hlinka Memorial,3,0,0,0,14,0,151451
2012-13,Oshawa Generals,OHL,64,15,28,43,61,7,118659
2012-13,Rouyn-Noranda Huskies,QMJHL,53,31,67,98,45,25,70426
2012-13,Switzerland U20,WJC-20,6,5,3,8,4,1,70426
2012-13,Switzerland U20 (all),International-Jr,13,8,6,14,8,,70426
2012-13,USNTDP Juniors,USHL,26,3,5,8,18,-2,108393
2012-13,U.S. National U18 Team,USDP,67,4,18,22,40,,108393
2012-13,USA U18,WJC-18,7,0,1,1,2,-2,108393
2012-13,Metallurg Novokuznetsk,KHL,15,3,0,3,2,-5,117748
2012-13,Salavat Yulaev Ufa,KHL,11,4,2,6,2,3,117748
2012-13,Tolpar Ufa,MHL,0,0,0,0,0,0,117748
2012-13,Russia U20,WJC-20,7,0,1,1,4,4,117748
2012-13,Russia U20,CAN-RUS Challenge,4,2,1,3,0,,117748
2012-13,Portland Winterhawks,WHL,65,31,32,63,10,38,92803
2012-13,Denmark U20,WJC-20 D1A,5,5,3,8,2,4,92803
2012-13,Denmark U20 (all),International-Jr,9,6,3,9,2,,92803
2012-13,Portland Winterhawks,M-Cup,5,1,2,3,4,1,92803
2012-13,Luleå HF J18,J18 Elit,4,5,4,9,0,10,153203
2012-13,Luleå HF J18,J18 Allsvenskan,6,3,5,8,0,3,153203
2012-13,Luleå HF J20,SuperElit,38,17,20,37,10,-1,153203
2012-13,Luleå HF,SHL,8,3,3,6,0,8,153203
2012-13,Slovakia U18,WJC-18,6,2,5,7,0,-2,153203
2012-13,Slovakia U18 (all),International-Jr,11,4,5,9,8,,153203
2012-13,Slovakia U18,Hlinka Memorial,2,0,0,0,0,-4,153203
2012-13,Kamloops Blazers,WHL,61,36,53,89,115,34,45487
2012-13,Canada U20,WJC-20,5,0,0,0,27,0,45487
2012-13,WHL All-Stars,Jr Super Series,1,0,0,0,6,-1,45487
2012-13,Edmonton Oil Kings,WHL,15,0,4,4,32,-2,64567
2012-13,Vancouver Giants,WHL,58,2,8,10,98,-26,64567
2012-13,Vancouver Giants,WHL,69,23,34,57,68,-16,101590
2012-13,Baie-Comeau Drakkar,QMJHL,58,23,38,61,58,18,88969
2012-13,London Knights,OHL,65,5,17,22,15,7,126916
2012-13,London Knights,M-Cup,5,1,1,2,0,1,126916
2012-13,Dubuque Fighting Saints,USHL,52,3,20,23,107,16,118432
2012-13,USA U18,Hlinka Memorial,4,0,1,1,2,1,118432
2012-13,USA U19,WJAC-19,4,0,1,1,28,,118432
2012-13,St. Michael's Buzzers,OJHL,50,40,31,71,107,,116977
2012-13,Canada East U19,WJAC-19,5,1,0,1,14,,116977
2012-13,St. Michael's Buzzers,Dudley Hewitt Cup,5,2,4,6,4,,116977
2012-13,Noble & Greenough School,USHS-Prep,15,8,10,18,18,,131890
2012-13,Cape Cod Whalers U18,MHSL U18,6,0,0,0,0,,131890
2012-13,Brampton Battalion,OHL,66,12,16,28,21,6,149617
2012-13,Djurgårdens IF J18,J18 Elit,7,6,9,15,2,12,85671
2012-13,Djurgårdens IF J18,J18 Allsvenskan,7,3,3,6,4,6,85671
2012-13,Djurgårdens IF J20,SuperElit,43,9,13,22,30,-2,85671
2012-13,Djurgårdens IF,Allsvenskan,5,0,1,1,0,1,85671
2012-13,Sweden U18 (all),International-Jr,2,2,1,3,0,0,85671
2012-13,Guelph Storm,OHL,68,16,17,33,39,5,117322
2012-13,Univ. of Michigan,NCAA,38,11,10,21,12,4,101962
2012-13,Saginaw Spirit,OHL,65,16,27,43,44,2,117024
2012-13,Shawinigan Cataractes,QMJHL,61,7,21,28,57,-40,129015
2012-13,Guelph Storm,OHL,67,3,12,15,59,14,144069
2012-13,West Kelowna Warriors,BCHL,42,17,22,39,20,,57035
2012-13,Prince Edward Island Rocket,QMJHL,68,3,13,16,90,7,103763
2012-13,Djurgårdens IF J18,J18 Elit,19,9,4,13,0,16,38721
2012-13,Djurgårdens IF J18,J18 Allsvenskan,11,1,3,4,16,5,38721
2012-13,Djurgårdens IF J20,SuperElit,33,1,4,5,4,-5,38721
2012-13,Sweden U18,WJC-18,5,0,0,0,2,2,38721
2012-13,Sweden U18 (all),International-Jr,10,0,1,1,2,2,38721
2012-13,Prince George Cougars,WHL,65,15,24,39,105,-4,121909
2012-13,Victory Honda  U18,T1EHL U18,37,17,23,40,41,,207023
2012-13,Rimouski Océanic,QMJHL,48,5,13,18,53,17,100867
2012-13,Czech Republic U18,WJC-18,5,0,2,2,2,1,100867
2012-13,Czech Republic U18 (all),International-Jr,6,0,2,2,2,1,100867
2012-13,Belleville Bulls,OHL,68,15,36,51,47,22,97951
2012-13,Canada U18,Hlinka Memorial,5,0,1,1,0,3,97951
2012-13,Gatineau Olympiques,QMJHL,47,22,28,50,56,-1,94282
2012-13,Slovakia U20,WJC-20,6,0,2,2,2,-4,94282
2012-13,Slovakia U20 (all),International-Jr,6,0,2,2,2,-4,94282
2012-13,USNTDP Juniors,USHL,25,4,7,11,8,0,114801
2012-13,U.S. National U18 Team,USDP,62,10,23,33,43,14,114801
2012-13,USA U18,WJC-18,7,0,6,6,4,4,114801
2012-13,Salisbury School,USHS-Prep,29,10,8,18,28,,162870
2012-13,Fairfield Blues Midget AAA,Midget,3,0,1,1,10,,162870
2012-13,Valley Jr. Warriors,EJHL,26,14,16,30,50,,150709
2012-13,U.S. National U18 Team,USDP,8,1,0,1,8,0,150709
2012-13,USA U19,WJAC-19,4,4,0,4,22,,150709
2012-13,USNTDP Juniors,USHL,26,11,6,17,6,14,151824
2012-13,U.S. National U18 Team,USDP,67,26,19,45,50,,151824
2012-13,USA U18,WJC-18,7,5,2,7,4,5,151824
2012-13,Blainville-Boisbriand Armada,QMJHL,67,34,43,77,71,17,128515
2012-13,QMJHL All-Stars,Jr Super Series,2,0,1,1,4,1,128515
2012-13,USNTDP Juniors,USHL,26,3,10,13,2,15,97590
2012-13,U.S. National U18 Team,USDP,67,11,26,37,8,,97590
2012-13,USA U18,WJC-18,7,2,2,4,2,2,97590
2012-13,Kärpät U20,Jr. A SM-liiga,45,23,35,58,43,19,73109
2012-13,Finland U19 (all),International-Jr,7,4,1,5,2,-2,73109
2012-13,Finland U20 (all),International-Jr,3,0,0,0,2,0,73109
2012-13,Kitchener Rangers,OHL,67,14,16,30,52,11,126917
2012-13,Omaha Lancers,USHL,64,14,14,28,49,-7,118006
2012-13,Langley Rivermen,BCHL,51,20,46,66,46,,59951
2012-13,MODO Hockey J20,SuperElit,36,19,21,40,28,14,26019
2012-13,MODO Hockey,SHL,7,1,0,1,2,1,26019
2012-13,Mora IK,Allsvenskan,3,0,0,0,0,-1,26019
2012-13,Sweden U19 (all),International-Jr,4,5,3,8,0,5,26019
2012-13,Sweden U20 (all),International-Jr,4,0,0,0,0,-1,26019
2012-13,Kamloops Blazers,WHL,62,22,28,50,37,27,62241
2012-13,Holderness School,USHS-Prep,29,12,14,26,-,,248322
2012-13,USNTDP Juniors,USHL,25,3,6,9,90,11,131370
2012-13,U.S. National U18 Team,USDP,66,8,15,23,114,7,131370
2012-13,USA U18,WJC-18,7,1,0,1,2,-3,131370
2012-13,USA U18,Hlinka Memorial,3,0,0,0,2,-1,131370
2012-13,Lincoln Stars,USHL,57,19,27,46,32,17,94247
2012-13,USA U19,WJAC-19,4,0,4,4,4,,94247
2012-13,Brandon Wheat Kings,WHL,72,17,22,39,37,-32,84740
2012-13,Linköping HC J18,J18 Elit,1,1,0,1,2,1,32639
2012-13,Linköping HC J18,J18 Allsvenskan,3,3,2,5,2,4,32639
2012-13,Linköping HC J20,SuperElit,35,12,23,35,24,10,32639
2012-13,Linköping HC,SHL,1,0,0,0,0,0,32639
2012-13,Sweden U18,WJC-18,4,0,1,1,8,-1,32639
2012-13,Sweden U18 (all),International-Jr,19,5,7,12,18,1,32639
2012-13,Sweden U18,Hlinka Memorial,5,2,3,5,0,5,32639
2012-13,Spruce Grove Saints,AJHL,35,5,10,15,71,,107449
2012-13,Val-d'Or Foreurs,QMJHL,53,25,27,52,98,21,126399
2012-13,Spruce Grove Saints,AJHL,1,0,0,0,2,,84090
2012-13,Kelowna Rockets,WHL,39,1,7,8,27,20,84090
2012-13,Burnsville High,USHS-MN,25,9,21,30,22,,141072
2012-13,Team Southeast,USHS-MN,20,3,4,7,8,,141072
2012-13,Fargo Force,USHL,4,0,1,1,0,1,141072
2012-13,USA U18,Hlinka Memorial,4,0,0,0,0,-2,141072
2012-13,Muskegon Lumberjacks,USHL,61,16,17,33,47,10,118436
2012-13,Zug U20,Elite Jr. A,32,28,17,45,26,,94494
2012-13,EV Zug,NLA,20,2,2,4,6,5,94494
2012-13,Switzerland U19 (all),International-Jr,7,2,0,2,4,,94494
2012-13,EV Zug,ET,3,0,0,0,0,,94494
2012-13,South Kent Prep.,USHS-Prep,62,21,32,53,68,,131905
2012-13,Sioux City Musketeers,USHL,42,3,17,20,110,12,118645
2012-13,USA U19,WJAC-19,4,1,1,2,8,,118645
2012-13,Rögle BK J18,J18 Elit,2,0,0,0,2,3,38743
2012-13,Rögle BK J18,J18 Allsvenskan,6,0,1,1,8,5,38743
2012-13,Rögle BK J20,SuperElit,36,5,8,13,64,27,38743
2012-13,Rögle BK,SHL,12,0,0,0,6,-1,38743
2012-13,Sweden U18 (all),International-Jr,9,1,2,3,6,6,38743
2012-13,Sweden U18,Hlinka Memorial,5,1,2,3,2,3,38743
2012-13,Team Northwest,USHS-MN,4,2,0,2,0,,177678
2012-13,Benilde-St. Margaret's School,USHS-MN,28,48,28,76,16,45,177678
2012-13,Omaha Lancers,USHL,7,4,0,4,0,-3,177678
2012-13,St. Cloud State Univ.,NCAA,42,22,11,33,10,28,108294
2012-13,Färjestad BK J18,J18 Elit,5,1,1,2,6,0,93903
2012-13,Färjestad BK J18,J18 Allsvenskan,3,2,3,5,2,4,93903
2012-13,Färjestad BK J20,SuperElit,34,5,12,17,6,8,93903
2012-13,Slovakia U18 (all),International-Jr,9,1,3,4,8,,93903
2012-13,Slovakia U18,Hlinka Memorial,4,0,1,1,6,-2,93903
2012-13,Hotchkiss School,USHS-Prep,26,4,6,10,32,,118671
2012-13,Fairfield Blues Midget AAA,Midget,20,2,5,7,-,,118671
2012-13,USNTDP Juniors,USHL,26,2,4,6,20,17,118008
2012-13,U.S. National U18 Team,USDP,66,2,12,14,54,,118008
2012-13,USA U18,WJC-18,7,0,2,2,6,5,118008
2012-13,Oshawa Generals,OHL,68,0,16,16,79,17,82512
2012-13,Muskegon Lumberjacks,USHL,52,2,10,12,82,8,195149
2012-13,Kingston Frontenacs,OHL,61,22,29,51,30,2,56268
2012-13,Finland U19 (all),International-Jr,3,0,0,0,4,0,56268
2012-13,Timrå IK J20,SuperElit,44,13,31,44,38,-4,27331
2012-13,Timrå IK,SHL,2,0,0,0,0,-1,27331
2012-13,Sault Ste. Marie Greyhounds,OHL,62,0,17,17,64,2,117753
2012-13,Dexter School,USHS-Prep,28,21,22,43,-,,255304
2012-13,Everett Silvertips,WHL,68,1,5,6,100,-21,102378
2012-13,USNTDP Juniors,USHL,15,5,8,13,17,12,118664
2012-13,U.S. National U18 Team,USDP,50,16,17,33,19,,118664
2012-13,USA U18,WJC-18,7,0,1,1,0,-2,118664
2012-13,USA U18,Hlinka Memorial,4,0,1,1,2,0,118664
2012-13,Kelowna Rockets,WHL,69,38,55,93,68,46,37197
2012-13,South Shore Kings,EJHL,44,13,20,33,38,,220346
2012-13,Merritt Centennials,BCHL,52,5,15,20,28,,151460
2012-13,Frölunda HC J18,J18 Elit,4,3,1,4,4,4,73397
2012-13,Frölunda HC J18,J18 Allsvenskan,3,1,0,1,6,-1,73397
2012-13,Frölunda HC J20,SuperElit,36,10,16,26,20,29,73397
2012-13,Norway U18,WJC-18 D1A,5,8,5,13,10,11,73397
2012-13,Norway U20,WJC-20 D1A,5,1,5,6,2,4,73397
2012-13,Peterborough Petes,OHL,26,9,17,26,14,-14,45411
2012-13,Belleville Bulls,OHL,28,14,27,41,6,29,45411
2012-13,Team North,USHS-MN,21,5,10,15,19,,147618
2012-13,Grand Rapids High,USHS-MN,23,23,31,54,2,,147618
2012-13,Sioux City Musketeers,USHL,8,1,3,4,7,3,147618
2012-13,Univ. of Denver,NCAA,39,10,9,19,22,2,90346
2012-13,Prince George Cougars,WHL,52,8,7,15,70,-18,83498
2012-13,Victoriaville Tigres,QMJHL,66,11,17,28,129,-6,126397
2012-13,Jokerit U20,Jr. A SM-liiga,46,5,18,23,34,-5,60924
2012-13,Jokerit,Liiga,2,0,0,0,0,1,60924
2012-13,Kiekko-Vantaa,Mestis,7,0,0,0,6,1,60924
2012-13,Finland U19 (all),International-Jr,3,0,0,0,2,,60924
2012-13,Finland U20 (all),International-Jr,3,0,0,0,0,0,60924
2012-13,St. John's Prep,USHS-Prep,21,12,24,36,24,,132024
2012-13,Spruce Grove Saints,AJHL,23,1,10,11,35,,54063
2012-13,Chicoutimi Saguenéens,QMJHL,35,7,8,15,71,-10,98666
2012-13,Baie-Comeau Drakkar,QMJHL,27,12,5,17,29,1,98666
2012-13,Canada U18,Hlinka Memorial,5,0,0,0,4,2,98666
2012-13,Blues U20,Jr. A SM-liiga,0,0,0,0,0,,44162
2012-13,Blues,Liiga,32,11,5,16,22,-2,44162
2012-13,Finland U20,WJC-20,1,2,1,3,0,2,44162
2012-13,Finland U20 (all),International-Jr,8,3,4,7,4,0,44162
2012-13,Guelph Storm,OHL,68,12,28,40,58,16,78063
2012-13,Kemptville 73s,CCHL,24,7,16,23,8,,117940
2012-13,Smiths Falls Bears,CCHL,27,5,24,29,16,,117940
2012-13,Canada East U19,WJAC-19,5,0,4,4,0,,117940
2012-13,Frölunda HC J18,J18 Elit,5,5,2,7,14,2,67179
2012-13,Frölunda HC J18,J18 Allsvenskan,3,0,0,0,0,-1,67179
2012-13,Frölunda HC J20,SuperElit,43,17,10,27,80,13,67179
2012-13,Sweden U18,WJC-18,5,1,0,1,0,1,67179
2012-13,Sweden U18 (all),International-Jr,16,2,2,4,6,3,67179
2012-13,Frölunda HC,ET,1,0,0,0,0,,67179
2012-13,USNTDP Juniors,USHL,24,10,15,25,10,10,151833
2012-13,U.S. National U18 Team,USDP,62,22,29,51,20,,151833
2012-13,USA U18,WJC-18,7,1,3,4,2,-1,151833
2012-13,Ilves U18,Jr. B SM-sarja,8,0,9,9,4,,92114
2012-13,Ilves U20,Jr. A SM-liiga,37,8,9,17,42,3,92114
2012-13,Ilves,Liiga,7,1,1,2,4,-2,92114
2012-13,Finland U18 (all),International-Jr,8,0,2,2,4,-1,92114
2012-13,Färjestad BK J18,J18 Elit,1,0,0,0,0,1,38745
2012-13,Färjestad BK J20,SuperElit,33,3,12,15,76,10,38745
2012-13,Färjestad BK,SHL,26,1,0,1,0,-1,38745
2012-13,Sweden U18,WJC-18,4,0,1,1,0,1,38745
2012-13,Sweden U18 (all),International-Jr,17,1,1,2,10,-1,38745
2012-13,Färjestad BK,ET,1,0,0,0,0,,38745
2012-13,Sweden U18,Hlinka Memorial,5,0,0,0,2,-2,38745
2012-13,Jokerit U20,Jr. A SM-liiga,4,1,2,3,2,-3,43302
2012-13,Jokerit,Liiga,13,1,1,2,12,0,43302
2012-13,Kiekko-Vantaa,Mestis,12,1,4,5,0,1,43302
2012-13,Finland U20,WJC-20,6,0,0,0,0,-1,43302
2012-13,Finland U20 (all),International-Jr,5,1,0,1,4,0,43302
2012-13,Jokerit,ET,1,0,0,0,0,,43302
2012-13,Penticton Vees,BCHL,50,23,47,70,50,,48368
2012-13,Canada West U19,WJAC-19,4,3,3,6,10,,48368
2012-13,SC Bern,NLA,47,13,22,35,14,26,34828
2012-13,Switzerland (all),International,2,0,0,0,0,-1,34828
2012-13,SC Bern,ET,8,3,1,4,0,,34828
2012-13,Loko Yaroslavl,MHL,53,1,9,10,38,11,165018
2012-13,Russia U18,WJC-18,7,0,5,5,10,6,165018
2012-13,Russia U18,Hlinka Memorial,4,0,0,0,2,2,165018
2012-13,Russia U19,WJAC-19,4,0,2,2,6,,165018
2012-13,Calgary Hitmen,WHL,69,17,32,49,58,11,84097
2012-13,Saginaw Spirit,OHL,68,44,53,97,84,37,76776
2012-13,Spokane Chiefs,WHL,71,22,63,85,30,39,32763
2012-13,Sudbury Wolves,OHL,67,17,17,34,25,-3,101221
2012-13,Czech Republic U18,WJC-18,5,0,5,5,14,1,101221
2012-13,Czech Republic U18 (all),International-Jr,5,0,5,5,14,1,101221
2012-13,Sudbury Wolves,JCWC,5,1,2,3,2,4,101221
2012-13,Chicago Fury  U18,T1EHL U18,40,2,4,6,16,,219791
2012-13,Des Moines Buccaneers,USHL,12,1,0,1,6,-13,219791
2012-13,Vernon Vipers,BCHL,26,5,12,17,29,,102264
2012-13,Penticton Vees,BCHL,22,14,15,29,33,,102264
2012-13,AIK J18,J18 Elit,22,10,22,32,20,30,88843
2012-13,AIK J18,J18 Allsvenskan,18,4,8,12,18,7,88843
2012-13,AIK J20,SuperElit,5,1,0,1,0,4,88843
2012-13,Dubuque Fighting Saints,USHL,63,33,37,70,18,29,57050
2012-13,Regina Pats,WHL,70,5,28,33,91,-8,87758
2012-13,Victoria Grizzlies,BCHL,51,5,19,24,16,,94974
2012-13,Canada West U19,WJAC-19,4,0,0,0,2,,94974
2012-13,Providence College,NCAA,38,4,9,13,35,3,146192
2012-13,Tingsryds AIF J18,J18 Elit,24,18,22,40,59,1,86073
2012-13,Tingsryds AIF J20,SuperElit,5,0,0,0,2,-3,86073
2012-13,Tartan Senior High,USHS-MN,25,29,27,56,10,,222712
2012-13,Team Northeast,USHS-MN,21,10,4,14,10,,222712
2012-13,Waterloo Black Hawks,USHL,2,1,0,1,0,0,222712
2012-13,Frölunda HC J20,SuperElit,42,23,31,54,54,29,43991
2012-13,Frölunda HC,SHL,7,1,0,1,0,0,43991
2012-13,Sweden U19 (all),International-Jr,4,2,3,5,8,2,43991
2012-13,Frölunda HC,ET,1,0,0,0,0,,43991
2012-13,Medicine Hat Tigers,WHL,69,2,24,26,131,14,88699
2012-13,London Knights,OHL,42,3,6,9,25,5,117010
2012-13,London Knights,M-Cup,1,0,0,0,2,-1,117010
2012-13,Halifax Mooseheads,QMJHL,62,8,36,44,58,55,97908
2012-13,Halifax Mooseheads,M-Cup,4,0,4,4,4,2,97908
2012-13,Lokomotiv Yaroslavl,KHL,33,7,13,20,10,8,42440
2012-13,Lokomotiv Yaroslavl-2,VHL,5,4,1,5,4,2,42440
2012-13,Loko Yaroslavl,MHL,2,1,1,2,2,-1,42440
2012-13,Russia (all),International,2,0,0,0,0,,42440
2012-13,St. Michael's Buzzers,OJHL,42,17,20,37,64,,117744
2012-13,Canada East U19,WJAC-19,5,1,1,2,8,,117744
2012-13,St. Michael's Buzzers,Dudley Hewitt Cup,5,3,2,5,6,,117744
2012-13,Sault Ste. Marie Greyhounds,OHL,36,1,4,5,17,0,116995
2012-13,Södertälje SK J20,SuperElit,26,7,9,16,16,2,36616
2012-13,Södertälje SK,Allsvenskan,41,2,2,4,10,-2,36616
2013-14,Barrie Colts,OHL,58,23,30,53,91,7,49042
2013-14,Canada U20,WJC-20,7,1,1,2,2,0,49042
2013-14,OHL All-Stars,Jr Super Series,2,0,0,0,0,1,49042
2013-14,Canada U18,Hlinka Memorial,5,2,3,5,4,4,49042
2013-14,Kootenay Ice,WHL,60,36,69,105,11,24,95032
2013-14,Canada U20,WJC-20,7,2,3,5,0,3,95032
2013-14,WHL All-Stars,Jr Super Series,2,0,1,1,2,2,95032
2013-14,Prince Albert Raiders,WHL,64,38,67,105,24,7,71913
2013-14,Germany U20,WJC-20,6,2,4,6,52,-1,71913
2013-14,Germany,WC,7,1,3,4,0,-3,71913
2013-14,Germany (all),International,13,1,5,6,0,-5,71913
2013-14,Kingston Frontenacs,OHL,57,36,55,91,118,34,189371
2013-14,OHL All-Stars,Jr Super Series,1,0,1,1,0,1,189371
2013-14,Canada U18,Hlinka Memorial,5,3,1,4,6,3,189371
2013-14,Oshawa Generals,OHL,67,39,56,95,34,8,152047
2013-14,OHL All-Stars,Jr Super Series,1,0,0,0,0,-2,152047
2013-14,Canada U18,Hlinka Memorial,5,2,2,4,4,-1,152047
2013-14,Calgary Hitmen,WHL,71,45,26,71,100,23,120197
2013-14,Canada U18,WJC-18,7,3,3,6,10,2,120197
2013-14,Canada U18,Hlinka Memorial,5,0,1,1,4,-2,120197
2013-14,Red Deer Rebels,WHL,70,8,38,46,46,15,119392
2013-14,Canada U18,WJC-18,7,0,1,1,4,0,119392
2013-14,Canada U18,Hlinka Memorial,5,1,0,1,6,0,119392
2013-14,MODO Hockey J18,J18 Allsvenskan,0,0,0,0,0,0,38703
2013-14,MODO Hockey J20,SuperElit,3,0,3,3,4,-1,38703
2013-14,MODO Hockey,SHL,22,1,6,7,6,-3,38703
2013-14,Rögle BK,Allsvenskan,18,4,4,8,10,0,38703
2013-14,Södertälje SK,Allsvenskan,17,11,8,19,6,2,38703
2013-14,Sweden U18,WJC-18,7,6,10,16,0,8,38703
2013-14,Sweden U18 (all),International-Jr,14,12,13,25,6,11,38703
2013-14,Sweden U18,Hlinka Memorial,4,4,2,6,4,1,38703
2013-14,Halifax Mooseheads,QMJHL,63,49,55,104,51,65,66581
2013-14,Denmark U20,WJC-20 D1A,5,2,4,6,4,6,66581
2013-14,Denmark U20 (all),International-Jr,5,2,4,6,4,,66581
2013-14,Peterborough Petes,OHL,61,39,35,74,136,4,99036
2013-14,HV71 J20,SuperElit,27,10,15,25,40,10,87971
2013-14,HV71,SHL,17,3,8,11,10,-2,87971
2013-14,Switzerland U18,WJC-18,5,4,5,9,8,4,87971
2013-14,Switzerland U18 (all),International-Jr,12,7,7,14,24,,87971
2013-14,Switzerland U20,WJC-20,5,1,4,5,6,-2,87971
2013-14,Switzerland U20 (all),International-Jr,9,5,9,14,6,,87971
2013-14,Switzerland,WC,7,0,2,2,2,3,87971
2013-14,Switzerland (all),International,9,0,2,2,4,3,87971
2013-14,HV71,ET,1,1,0,1,0,,87971
2013-14,Switzerland U18,Hlinka Memorial,4,2,0,2,12,0,87971
2013-14,Niagara IceDogs,OHL,58,34,37,71,36,-2,186992
2013-14,Canada U18,WJC-18,7,3,1,4,6,2,186992
2013-14,Linköping HC J18,J18 Allsvenskan,1,0,0,0,0,0,101250
2013-14,Linköping HC J20,SuperElit,24,14,11,25,26,6,101250
2013-14,Linköping HC,SHL,24,2,1,3,2,-3,101250
2013-14,Czech Republic U18,WJC-18,7,8,2,10,4,3,101250
2013-14,Czech Republic U18 (all),International-Jr,16,14,6,20,12,7,101250
2013-14,Czech Republic U20,WJC-20,5,1,1,2,2,-1,101250
2013-14,Czech Republic U20 (all),International-Jr,9,3,4,7,6,-1,101250
2013-14,Linköping HC,ET,8,1,2,3,6,,101250
2013-14,Czech Republic U18,Hlinka Memorial,4,3,1,4,4,4,101250
2013-14,Swift Current Broncos,WHL,62,16,40,56,52,10,65456
2013-14,Finland U20,WJC-20,7,0,1,1,6,1,65456
2013-14,Finland U20 (all),International-Jr,5,0,1,1,0,,65456
2013-14,USNTDP Juniors,USHL,26,17,9,26,24,13,177693
2013-14,U.S. National U18 Team,USDP,60,31,25,56,56,,177693
2013-14,USA U18,WJC-18,6,2,2,4,2,3,177693
2013-14,USNTDP Juniors,USHL,25,14,25,39,21,21,189415
2013-14,U.S. National U18 Team,USDP,58,29,57,86,23,,189415
2013-14,USA U18,WJC-18,7,3,7,10,4,6,189415
2013-14,Calgary Hitmen,WHL,67,5,24,29,14,25,120938
2013-14,Canada U18,WJC-18,7,0,6,6,0,5,120938
2013-14,USNTDP Juniors,USHL,26,13,19,32,36,18,178526
2013-14,U.S. National U18 Team,USDP,61,29,35,64,70,,178526
2013-14,USA U18,WJC-18,7,0,3,3,14,5,178526
2013-14,Sarnia Sting,OHL,51,15,56,71,90,-34,89818
2013-14,Green Bay Gamblers,USHL,55,18,45,63,16,-3,156966
2013-14,U.S. National U18 Team,USDP,2,0,0,0,0,,156966
2013-14,USA U18,Hlinka Memorial,5,5,3,8,2,0,156966
2013-14,USA U19,WJAC-19,4,4,8,12,0,,156966
2013-14,Guelph Storm,OHL,58,45,42,87,55,45,156923
2013-14,Canada U18,Hlinka Memorial,5,0,1,1,4,-2,156923
2013-14,Guelph Storm,M-Cup,4,2,4,6,4,2,156923
2013-14,KalPa U18,Jr. B SM-sarja,2,5,1,6,0,,92226
2013-14,KalPa,Liiga,47,7,7,14,10,-8,92226
2013-14,Finland U18,WJC-18,5,1,1,2,0,-3,92226
2013-14,Finland U18 (all),International-Jr,5,1,1,2,0,-3,92226
2013-14,Finland U20 (all),International-Jr,5,1,0,1,0,,92226
2013-14,KalPa,ET,6,3,0,3,16,,92226
2013-14,Red Deer Rebels,WHL,71,29,39,68,48,3,84020
2013-14,Canada U18,WJC-18,7,1,1,2,4,0,84020
2013-14,WHL All-Stars,Jr Super Series,1,0,0,0,4,-1,84020
2013-14,Sault Ste. Marie Greyhounds,OHL,64,27,35,62,51,9,189369
2013-14,Canada U18,WJC-18,7,1,2,3,6,2,189369
2013-14,Canada U18,Hlinka Memorial,5,1,0,1,0,0,189369
2013-14,Södertälje SK J20,SuperElit,1,1,1,2,0,-1,130383
2013-14,Södertälje SK,Allsvenskan,36,8,16,24,24,7,130383
2013-14,Czech Republic U18,WJC-18,7,0,5,5,2,1,130383
2013-14,Czech Republic U18 (all),International-Jr,12,3,7,10,6,5,130383
2013-14,Czech Republic U20,WJC-20,5,1,2,3,0,1,130383
2013-14,Czech Republic U20 (all),International-Jr,11,3,2,5,27,2,130383
2013-14,Czech Republic U18,Hlinka Memorial,4,2,2,4,2,2,130383
2013-14,Saskatoon Blades,WHL,65,28,50,78,46,-6,209468
2013-14,Russian Selects,Jr Super Series,1,0,1,1,0,1,209468
2013-14,Sarnia Sting,OHL,67,38,56,94,21,-30,160550
2013-14,Russian Selects,Jr Super Series,2,0,1,1,0,0,160550
2013-14,Windsor Spitfires,OHL,67,32,53,85,44,26,161290
2013-14,MODO Hockey J18,J18 Allsvenskan,0,0,0,0,0,0,86313
2013-14,MODO Hockey J20,SuperElit,20,3,16,19,32,6,86313
2013-14,MODO Hockey,SHL,45,5,6,11,12,5,86313
2013-14,Sweden U18,WJC-18,7,1,6,7,16,-2,86313
2013-14,Sweden U18 (all),International-Jr,16,7,8,15,26,-3,86313
2013-14,MODO Hockey J20,U20 Super Challenge,5,1,2,3,12,-3,86313
2013-14,Sweden U18,Hlinka Memorial,4,2,1,3,12,-1,86313
2013-14,Brandon Wheat Kings,WHL,61,25,33,58,71,3,84092
2013-14,Canada U18,WJC-18,7,1,1,2,16,1,84092
2013-14,Barrie Colts,OHL,65,27,26,53,145,-7,177647
2013-14,Canada U18,Hlinka Memorial,5,1,1,2,4,1,177647
2013-14,Brandon Wheat Kings,WHL,59,24,40,64,44,16,120626
2013-14,Canada U18,WJC-18,6,0,2,2,10,0,120626
2013-14,Canada U18,Hlinka Memorial,5,1,0,1,6,1,120626
2013-14,Moncton Wildcats,QMJHL,48,25,43,68,27,-11,108659
2013-14,Russia U20,WJC-20,7,1,1,2,0,1,108659
2013-14,Russian Selects,Jr Super Series,2,2,0,2,0,1,108659
2013-14,HC Slavia Praha U18,Czech U18,0,0,0,0,0,,127501
2013-14,HC Slavia Praha U20,Czech U20,39,2,19,21,102,6,127501
2013-14,Czech Republic U18,WJC-18,7,0,3,3,6,3,127501
2013-14,Czech Republic U18 (all),International-Jr,28,1,9,10,51,3,127501
2013-14,Czech Republic U18,Hlinka Memorial,4,0,0,0,4,0,127501
2013-14,Czech Republic U18/19,WJAC-19,4,0,2,2,4,,127501
2013-14,Skellefteå AIK J18,J18 Allsvenskan,0,0,0,0,0,0,86321
2013-14,Skellefteå AIK J20,SuperElit,38,4,14,18,38,4,86321
2013-14,Skellefteå AIK,SHL,10,0,0,0,2,2,86321
2013-14,Sweden U18,WJC-18,7,1,0,1,2,1,86321
2013-14,Sweden U18 (all),International-Jr,15,1,2,3,4,-1,86321
2013-14,Djurgårdens IF J18,J18 Elit,1,1,0,1,0,1,115148
2013-14,Djurgårdens IF J20,SuperElit,33,5,5,10,26,3,115148
2013-14,Djurgårdens IF,Allsvenskan,19,1,1,2,14,4,115148
2013-14,Sweden U18,WJC-18,7,0,0,0,6,6,115148
2013-14,Sweden U18 (all),International-Jr,20,1,1,2,20,8,115148
2013-14,Sweden U18,Hlinka Memorial,4,1,1,2,4,4,115148
2013-14,Indiana Ice,USHL,56,5,18,23,46,36,168704
2013-14,USA U19,WJAC-19,4,0,0,0,0,,168704
2013-14,Metallurg Magnitogorsk,KHL,16,1,0,1,2,-1,216659
2013-14,Yuzhny Ural Orsk,VHL,3,0,1,1,2,-1,216659
2013-14,Stalnye Lisy Magnitogorsk,MHL,15,4,6,10,12,10,216659
2013-14,Russia U18,WJC-18,5,2,5,7,2,0,216659
2013-14,Russia U18,Hlinka Memorial,4,0,0,0,2,2,216659
2013-14,Russia U19,WJAC-19,5,1,6,7,26,,216659
2013-14,Kitchener Rangers,OHL,66,16,21,37,18,-28,168707
2013-14,Peterborough Petes,OHL,68,25,37,62,25,2,154475
2013-14,Edmonton Oil Kings,WHL,71,25,30,55,36,18,84111
2013-14,Edmonton Oil Kings,M-Cup,5,0,2,2,4,0,84111
2013-14,Frölunda HC J20,SuperElit,45,13,21,34,54,15,38929
2013-14,Frölunda HC,SHL,1,0,0,0,4,0,38929
2013-14,Sweden U19 (all),International-Jr,4,1,2,3,0,2,38929
2013-14,Frölunda HC,ET,2,0,0,0,0,,38929
2013-14,USNTDP Juniors,USHL,26,0,2,2,10,12,120935
2013-14,U.S. National U18 Team,USDP,59,1,6,7,26,,120935
2013-14,USA U18,WJC-18,7,0,2,2,6,4,120935
2013-14,Val-d'Or Foreurs,QMJHL,65,22,31,53,61,-1,151146
2013-14,Val-d'Or Foreurs,M-Cup,4,0,0,0,2,0,151146
2013-14,Gatineau Olympiques,QMJHL,65,21,26,47,40,4,130789
2013-14,Czech Republic U18,WJC-18,7,3,3,6,4,4,130789
2013-14,Czech Republic U18 (all),International-Jr,12,3,5,8,6,3,130789
2013-14,Czech Republic U18,Hlinka Memorial,4,0,2,2,2,-1,130789
2013-14,Kingston Frontenacs,OHL,62,11,32,43,61,38,189364
2013-14,Canada U18,WJC-18,7,0,1,1,2,3,189364
2013-14,Canada U18,Hlinka Memorial,5,0,1,1,6,0,189364
2013-14,USNTDP Juniors,USHL,23,4,8,12,34,20,204300
2013-14,U.S. National U18 Team,USDP,57,7,14,21,65,33,204300
2013-14,USA U18,WJC-18,7,2,2,4,0,7,204300
2013-14,USA U18,Hlinka Memorial,5,1,2,3,10,-1,204300
2013-14,Youngstown Phantoms,USHL,60,19,24,43,42,-17,233028
2013-14,Genève-Servette U20,Elite Jr. A,31,16,21,37,58,,97120
2013-14,Genève-Servette HC,NLA,28,1,2,3,8,0,97120
2013-14,Switzerland U18,WJC-18,5,2,4,6,22,8,97120
2013-14,Switzerland U18 (all),International-Jr,18,9,8,17,24,,97120
2013-14,Switzerland U18,Hlinka Memorial,4,0,1,1,2,1,97120
2013-14,Oshawa Generals,OHL,64,16,24,40,100,11,117017
2013-14,Waterloo Black Hawks,USHL,60,14,48,62,36,35,97957
2013-14,Dexter School,USHS-Prep,30,37,41,78,-,,195235
2013-14,Cape Cod Whalers U18,MHSL U18,9,8,9,17,33,,195235
2013-14,U.S. National U18 Team,USDP,4,1,0,1,0,,195235
2013-14,USNTDP Juniors,USHL,19,1,4,5,36,-1,177674
2013-14,U.S. National U18 Team,USDP,51,5,6,11,70,,177674
2013-14,USA U18,WJC-18,7,2,1,3,0,4,177674
2013-14,London Knights,OHL,33,6,8,14,0,8,194889
2013-14,London Knights,M-Cup,3,0,0,0,0,-1,194889
2013-14,Ottawa 67's,OHL,68,4,17,21,26,-38,50668
2013-14,Kelowna Rockets,WHL,68,17,31,48,40,23,63133
2013-14,Portland Winterhawks,WHL,65,10,21,31,31,18,120642
2013-14,USA U18,Hlinka Memorial,5,0,1,1,0,1,120642
2013-14,Spruce Grove Saints,AJHL,49,4,18,22,29,,64587
2013-14,Canada West U19,WJAC-19,4,0,1,1,2,,64587
2013-14,Spruce Grove Saints,Western Canada Cup,6,0,0,0,6,,64587
2013-14,Ässät U20,Jr. A SM-liiga,37,17,25,42,32,24,151955
2013-14,Ässät,Liiga,20,0,1,1,0,-4,151955
2013-14,Finland U18,WJC-18,5,2,4,6,2,1,151955
2013-14,Finland U18 (all),International-Jr,20,7,7,14,8,,151955
2013-14,Finland U18,Hlinka Memorial,4,3,3,6,6,3,151955
2013-14,Avtomobilist Yekaterinburg,KHL,45,1,6,7,38,2,123119
2013-14,Avto Yekaterinburg,MHL,2,2,1,3,4,2,123119
2013-14,Russia U20,WJC-20,7,1,2,3,2,5,123119
2013-14,St. Andrew's College,MPHL,13,12,17,29,14,,210317
2013-14,St. Andrew's College,CISAA,14,17,6,23,15,,210317
2013-14,St. Andrew's College,CAHS,17,18,17,35,26,,210317
2013-14,Kootenay Ice,WHL,55,5,23,28,68,27,159029
2013-14,Russian Selects,Jr Super Series,2,0,0,0,2,-1,159029
2013-14,USNTDP Juniors,USHL,24,1,9,10,12,4,168703
2013-14,U.S. National U18 Team,USDP,59,2,26,28,30,10,168703
2013-14,USA U18,WJC-18,7,1,3,4,0,2,168703
2013-14,The Rivers School,USHS-Prep,22,6,13,19,-,,248347
2013-14,Neponset Valley River Rats U18,MHSL U18,11,1,8,9,4,,248347
2013-14,Plymouth Whalers,OHL,54,13,18,31,51,-17,114799
2013-14,Portland Winterhawks,WHL,72,18,18,36,121,19,118437
2013-14,Swift Current Broncos,WHL,72,8,14,22,103,7,104226
2013-14,Swift Current Broncos,WHL,72,6,31,37,42,-16,62212
2013-14,Plymouth Whalers,OHL,50,3,6,9,44,-3,196066
2013-14,Niagara IceDogs,OHL,68,6,24,30,24,-16,192880
2013-14,Moose Jaw Warriors,WHL,72,36,55,91,53,-27,62204
2013-14,Canada U18,WJC-18,4,0,2,2,2,1,62204
2013-14,Canada U18,Hlinka Memorial,5,1,3,4,2,3,62204
2013-14,USNTDP Juniors,USHL,26,5,10,15,24,5,177686
2013-14,U.S. National U18 Team,USDP,61,7,16,23,44,14,177686
2013-14,USA U18,WJC-18,7,0,2,2,0,3,177686
2013-14,Saginaw Spirit,OHL,68,27,9,36,69,14,194119
2013-14,Toronto Jr. Canadiens,OJHL,43,7,26,33,87,,248066
2013-14,Canada East U19,WJAC-19,4,0,2,2,4,,248066
2013-14,Muskegon Lumberjacks,USHL,58,41,23,64,47,12,152075
2013-14,North Bay Battalion,OHL,33,2,10,12,21,15,189639
2013-14,Portland Winterhawks,WHL,67,22,20,42,70,16,185603
2013-14,USA U18,Hlinka Memorial,5,1,0,1,4,2,185603
2013-14,Waterloo Black Hawks,USHL,51,10,30,40,30,22,107113
2013-14,Frölunda HC J18,J18 Elit,1,0,1,1,4,0,88845
2013-14,Frölunda HC J18,J18 Allsvenskan,4,2,4,6,6,2,88845
2013-14,Frölunda HC J20,SuperElit,28,12,10,22,88,3,88845
2013-14,Mora IK,Allsvenskan,9,0,0,0,2,-3,88845
2013-14,Sweden U18,WJC-18,7,0,0,0,4,-2,88845
2013-14,Sweden U18 (all),International-Jr,17,3,6,9,10,-1,88845
2013-14,Sweden U20,WJC-20,5,0,0,0,0,1,88845
2013-14,Sweden U20 (all),International-Jr,10,1,0,1,4,1,88845
2013-14,Frölunda HC J20,JCWC,4,4,1,5,4,0,88845
2013-14,Sweden U18,Hlinka Memorial,4,1,4,5,0,0,88845
2013-14,South Shore Kings,USPHL Premier,48,11,36,47,94,,252369
2013-14,Hershey Bears,AHL,43,5,6,11,40,-3,101430
2013-14,North Bay Battalion,OHL,64,12,26,38,14,15,151385
2013-14,Frölunda HC J18,J18 Allsvenskan,4,0,1,1,0,4,86158
2013-14,Frölunda HC J20,SuperElit,44,8,12,20,30,27,86158
2013-14,Sweden U18,WJC-18,7,3,0,3,6,5,86158
2013-14,Sweden U18 (all),International-Jr,19,5,4,9,16,9,86158
2013-14,Frölunda HC J20,JCWC,4,1,1,2,2,2,86158
2013-14,Sweden U18,Hlinka Memorial,4,1,1,2,2,3,86158
2013-14,USNTDP Juniors,USHL,25,2,1,3,78,1,130916
2013-14,U.S. National U18 Team,USDP,60,3,6,9,123,,130916
2013-14,USA U18,WJC-18,7,0,2,2,4,1,130916
2013-14,Kitchener Rangers,OHL,66,20,26,46,20,-18,135423
2013-14,Plymouth Whalers,OHL,68,2,7,9,62,-6,189578
2013-14,Luleå HF,SHL,41,3,7,10,2,-4,39022
2013-14,Asplöven HC,Allsvenskan,11,1,7,8,6,4,39022
2013-14,Sweden U20,WJC-20,7,3,5,8,2,5,39022
2013-14,Sweden U20 (all),International-Jr,17,5,9,14,6,7,39022
2013-14,Luleå HF,ET,6,1,1,2,0,,39022
2013-14,Green Bay Gamblers,USHL,28,2,4,6,21,-6,195218
2013-14,Chicago Steel,USHL,24,4,11,15,24,-2,195218
2013-14,Sweden U18 (all),International-Jr,6,1,4,5,2,0,195218
2013-14,Sweden U18,Hlinka Memorial,4,0,1,1,2,2,195218
2013-14,Portland Winterhawks,WHL,72,39,42,81,36,49,116909
2013-14,Dubuque Fighting Saints,USHL,53,16,24,40,71,18,177720
2013-14,Dubuque Fighting Saints,JCWC,3,0,2,2,0,0,177720
2013-14,USA U19,WJAC-19,4,2,0,2,2,,177720
2013-14,Saskatoon Blades,WHL,37,1,5,6,25,-2,120646
2013-14,Baie-Comeau Drakkar,QMJHL,61,15,21,36,52,11,128447
2013-14,QMJHL All-Stars,Jr Super Series,1,0,0,0,0,0,128447
2013-14,Youngstown Phantoms,USHL,60,27,31,58,31,-12,191113
2013-14,U.S. National U18 Team,USDP,1,0,0,0,0,,191113
2013-14,Sioux City Musketeers,USHL,29,1,5,6,51,0,203339
2013-14,Indiana Ice,USHL,24,2,7,9,20,11,203339
2013-14,USA U18,Hlinka Memorial,5,0,1,1,27,2,203339
2013-14,USA U19,WJAC-19,4,0,0,0,16,,203339
2013-14,Toronto Lakeshore Patriots,OJHL,47,5,49,54,2,,195224
2013-14,Toronto Lakeshore Patriots,Dudley Hewitt Cup,5,2,3,5,4,,195224
2013-14,Toronto Lakeshore Patriots,RBC Cup,4,2,1,3,0,,195224
2013-14,Canada East U19,WJAC-19,4,0,2,2,0,,195224
2013-14,Frölunda HC J18,J18 Elit,8,4,5,9,4,11,115020
2013-14,Frölunda HC J18,J18 Allsvenskan,7,4,5,9,0,4,115020
2013-14,Frölunda HC J20,SuperElit,45,4,7,11,14,-7,115020
2013-14,Frölunda HC,SHL,2,0,0,0,0,0,115020
2013-14,Sweden U18,WJC-18,7,0,3,3,0,-1,115020
2013-14,Sweden U18 (all),International-Jr,7,0,3,3,0,-1,115020
2013-14,Frölunda HC J20,JCWC,4,0,1,1,0,1,115020
2013-14,Cape Breton Screaming Eagles,QMJHL,67,25,25,50,28,-8,149432
2013-14,Quinnipiac Univ.,NCAA,37,1,16,17,10,10,59575
2013-14,Tri-City Storm,USHL,55,19,12,31,57,-27,231724
2013-14,USA U18,Hlinka Memorial,5,0,2,2,4,-2,231724
2013-14,USA U19,WJAC-19,4,0,1,1,0,,231724
2013-14,Skellefteå AIK,SHL,50,16,24,40,59,4,27484
2013-14,Sweden,EHT,3,0,0,0,2,-1,27484
2013-14,Sweden (all),International,3,0,0,0,2,-1,27484
2013-14,Deerfield Academy,USHS-Prep,25,21,34,55,-,,259043
2013-14,Boston Jr. Bruins Selects U18,MHSL U18,11,2,9,11,2,,259043
2013-14,Charlottetown Islanders,QMJHL,37,8,9,17,58,-8,128459
2013-14,Gatineau Olympiques,QMJHL,23,9,8,17,11,7,128459
2013-14,Canada U18,Hlinka Memorial,5,0,0,0,0,0,128459
2013-14,Surrey Eagles,BCHL,57,29,33,62,8,,105821
2013-14,Sault Ste. Marie Greyhounds,OHL,48,15,27,42,34,10,245191
2013-14,Calgary Hitmen,WHL,72,7,24,31,39,11,62287
2013-14,Canada U18,WJC-18,7,0,1,1,2,2,62287
2013-14,Omaha Lancers,USHL,56,5,26,31,6,23,218982
2013-14,USA U19,WJAC-19,4,0,2,2,6,,218982
2013-14,Williston Northampton School,USHS-Prep,25,21,23,44,-,,300657
2013-14,Springfield Rifles U18,MHSL U18,11,5,13,18,6,,300657
2013-14,Brandon Wheat Kings,WHL,66,32,25,57,75,-12,100577
2013-14,Czech Republic U20 (all),International-Jr,-,-,-,-,-,,100577
2013-14,Ashwaubenon High,USHS-WI,24,11,26,37,12,,220352
2013-14,Team Wisconsin,USHS-WI,21,3,10,13,0,,220352
2013-14,Kootenay Ice,WHL,70,44,54,98,54,27,64576
2013-14,WHL All-Stars,Jr Super Series,1,0,0,0,0,0,64576
2013-14,Olds Grizzlys,AJHL,51,5,13,18,153,,84120
2013-14,Linköping HC J18,J18 Elit,2,1,2,3,0,2,86366
2013-14,Linköping HC J18,J18 Allsvenskan,3,2,1,3,2,-2,86366
2013-14,Linköping HC J20,SuperElit,44,6,12,18,36,-3,86366
2013-14,Sweden U18,WJC-18,7,4,1,5,2,2,86366
2013-14,Sweden U18 (all),International-Jr,15,5,3,8,8,2,86366
2013-14,Sweden U18,Hlinka Memorial,4,0,0,0,6,-1,86366
2013-14,Cape Breton Screaming Eagles,QMJHL,56,14,19,33,54,-8,191376
2013-14,Canada U18,WJC-18,7,0,1,1,2,1,191376
2013-14,Canada U18,Hlinka Memorial,5,1,0,1,4,2,191376
2013-14,Sioux Falls Stampede,USHL,55,17,21,38,58,6,194948
2013-14,Sioux Falls Stampede,USHL,53,22,29,51,43,19,195507
2013-14,USA U19,WJAC-19,4,2,1,3,6,,195507
2013-14,Vernon Vipers,BCHL,53,18,27,45,70,,248303
2013-14,Vernon Vipers,RBC Cup,5,1,1,2,4,,248303
2013-14,Kamloops Blazers,WHL,72,4,16,20,182,-4,83900
2013-14,KalPa U20,Jr. A SM-liiga,24,7,17,24,32,-7,66296
2013-14,KalPa,Liiga,30,3,6,9,24,-3,66296
2013-14,KalPa,ET,4,0,1,1,0,,66296
2013-14,Edmonton Oil Kings,WHL,63,7,28,35,50,17,120638
2013-14,Edmonton Oil Kings,M-Cup,5,0,1,1,0,1,120638
2013-14,USNTDP Juniors,USHL,26,8,8,16,4,8,168706
2013-14,U.S. National U18 Team,USDP,61,16,16,32,18,7,168706
2013-14,USA U18,WJC-18,7,0,0,0,2,2,168706
2013-14,Jokerit U18,Jr. B SM-sarja,38,1,7,8,57,,151918
2013-14,Kiekko-Vantaa U18,Jr. B Mestis,1,0,0,0,0,,151918
2013-14,Kimball Union Academy,USHS-Prep,37,33,27,60,-,,178706
2013-14,Brynäs IF J18,J18 Elit,4,5,4,9,0,6,86181
2013-14,Brynäs IF J18,J18 Allsvenskan,2,3,1,4,0,3,86181
2013-14,Brynäs IF J20,SuperElit,43,13,20,33,28,2,86181
2013-14,Brynäs IF,SHL,4,0,0,0,0,-2,86181
2013-14,Sweden U18,WJC-18,7,3,3,6,2,5,86181
2013-14,Sweden U18 (all),International-Jr,20,10,11,21,4,10,86181
2013-14,Sweden U18,Hlinka Memorial,4,2,2,4,0,4,86181
2013-14,Kootenay Ice,WHL,10,0,1,1,9,-1,101642
2013-14,Blainville-Boisbriand Armada,QMJHL,67,10,29,39,71,15,257725
2013-14,QMJHL All-Stars,Jr Super Series,2,0,1,1,0,2,257725
2013-14,Eden Prairie High,USHS-MN,25,8,30,38,19,1,196703
2013-14,Team Southeast,USHS-MN,19,5,16,21,8,,196703
2013-14,Muskegon Lumberjacks,USHL,3,1,2,3,0,3,196703
2013-14,Omaha Lancers,USHL,4,0,2,2,6,2,196703
2013-14,Eden Prairie High,MN State,3,0,2,2,2,,196703
2013-14,Team Southwest,USHS-MN,20,2,6,8,18,,194952
2013-14,Edina High,USHS-MN,25,7,20,27,41,,194952
2013-14,Sioux Falls Stampede,USHL,4,0,2,2,4,1,194952
2013-14,U.S. National U18 Team,USDP,1,0,0,0,2,,194952
2013-14,Edina High,MN State,3,4,4,8,7,4,194952
2013-14,Edina High,USHS-MN,25,16,25,41,24,,248353
2013-14,Team Southwest,USHS-MN,20,5,4,9,32,,248353
2013-14,Edina High,MN State,3,2,3,5,4,3,248353
2013-14,Skellefteå AIK J20,SuperElit,39,1,5,6,34,3,39019
2013-14,Skellefteå AIK,SHL,7,0,0,0,4,-4,39019
2013-14,Piteå HC,Division 1,1,0,1,1,0,0,39019
2013-14,Sweden U20 (all),International-Jr,8,1,1,2,27,1,39019
2013-14,Omaha Lancers,USHL,58,11,10,21,85,-10,178527
2013-14,USNTDP Juniors,USHL,26,9,12,21,0,14,183809
2013-14,U.S. National U18 Team,USDP,61,21,20,41,10,21,183809
2013-14,USA U18,WJC-18,7,2,0,2,4,4,183809
2013-14,Sherbrooke Phoenix,QMJHL,68,21,55,76,79,-37,128505
2013-14,Canada U18,WJC-18,7,2,1,3,14,0,128505
2013-14,QMJHL All-Stars,Jr Super Series,1,1,1,2,0,2,128505
2013-14,Canada U18,Hlinka Memorial,5,1,2,3,2,1,128505
2013-14,Skellefteå AIK J18,J18 Elit,8,1,1,2,14,7,107557
2013-14,Skellefteå AIK J18,J18 Allsvenskan,4,0,1,1,6,2,107557
2013-14,Skellefteå AIK J20,SuperElit,36,1,5,6,14,3,107557
2013-14,Kelowna Rockets,WHL,72,24,34,58,8,26,120201
2013-14,Canada U18,Hlinka Memorial,5,0,1,1,0,2,120201
2013-14,Cranbrook-Kingswood Upper School,USHS-MI,28,26,58,84,21,,248309
2013-14,MDHL Orange,MDHL,11,11,6,17,0,,248309
2013-14,Green Bay Gamblers,USHL,2,0,0,0,0,1,248309
2013-14,Kimball Union Academy,USHS-Prep,25,9,35,44,-,,211276
2013-14,Boston Jr. Bruins Selects U18,MHSL U18,5,0,1,1,4,,211276
2013-14,Islanders Hockey Club,USPHL Premier,2,0,0,0,12,,211276
2013-14,USA U18,Hlinka Memorial,5,1,2,3,0,-1,211276
2013-14,Omaha Lancers,USHL,49,33,38,71,22,40,121879
2013-14,Niagara IceDogs,OHL,61,5,11,16,112,-39,189374
2013-14,USA U18,Hlinka Memorial,5,0,0,0,10,1,189374
2013-14,Ferris State Univ.,NCAA,43,10,15,25,12,10,121949
2013-14,Erie Otters,OHL,53,5,5,10,24,3,204921
2013-14,Belleville Bulls,OHL,57,10,22,32,53,4,95924
2013-14,South Shore Kings U18,USPHL 18U,1,2,1,3,0,,248373
2013-14,South Shore Kings,USPHL Premier,48,26,40,66,30,,248373
2013-14,Eden Prairie High,USHS-MN,25,17,22,39,42,3,196597
2013-14,Team Southeast,USHS-MN,20,7,13,20,24,,196597
2013-14,Muskegon Lumberjacks,USHL,3,2,1,3,0,3,196597
2013-14,Omaha Lancers,USHL,8,0,2,2,14,-2,196597
2013-14,Eden Prairie High,MN State,3,3,0,3,2,,196597
2013-14,Östersunds IK J18,J18 Elit,6,1,2,3,0,8,86227
2013-14,Östersunds IK J20,J20 Elit,4,0,2,2,4,3,86227
2013-14,Östersunds IK,Division 1,21,3,1,4,8,10,86227
2013-14,Edmonton Oil Kings,WHL,56,6,11,17,128,5,83627
2013-14,Edmonton Oil Kings,M-Cup,5,0,0,0,2,2,83627
2013-14,Edmonton Oil Kings,WHL,63,9,21,30,88,26,84245
2013-14,Edmonton Oil Kings,M-Cup,5,0,0,0,2,-4,84245
2013-14,Brynäs IF J20,SuperElit,33,5,5,10,61,9,67162
2013-14,Brynäs IF,SHL,21,0,1,1,0,0,67162
2013-14,Sweden U19 (all),International-Jr,4,0,1,1,2,4,67162
2013-14,Lokomotiv Yaroslavl,KHL,8,1,0,1,14,1,212441
2013-14,Loko Yaroslavl,MHL,39,10,17,27,16,22,212441
2013-14,Russia U18,WJC-18,5,0,1,1,2,0,212441
2013-14,Russia U18 (all),International-Jr,17,0,7,7,10,,212441
2013-14,Russia U19,WJAC-19,5,0,1,1,2,,212441
2013-14,Frölunda HC J18,J18 Elit,16,5,20,25,8,29,146820
2013-14,Frölunda HC J18,J18 Allsvenskan,17,6,7,13,14,-2,146820
2013-14,Frölunda HC J20,SuperElit,19,1,3,4,0,8,146820
2013-14,Frölunda HC J20,JCWC,4,0,0,0,4,0,146820
2013-14,TPS U20,Jr. A SM-liiga,33,18,21,39,6,20,73323
2013-14,TPS,Liiga,18,3,0,3,0,2,73323
2013-14,Calgary Hitmen,WHL,68,10,15,25,52,13,120657
2013-14,Calgary Hitmen,WHL,38,5,20,25,12,1,231738
2013-14,Russia U18,WJC-18,5,0,1,1,2,-1,231738
2013-14,Russia U18,Hlinka Memorial,4,1,2,3,0,0,231738
2013-14,Lethbridge Hurricanes,WHL,62,15,25,40,91,-47,62308
2013-14,Hamilton Red Wings,OJHL,9,8,3,11,37,,204054
2013-14,Windsor Spitfires,OHL,50,17,11,28,101,8,204054
2013-14,Barrie Colts,OHL,65,11,24,35,30,3,133841
2013-14,WB/Scranton Knights 18U,AYHL 18U,10,6,7,13,60,,276562
2013-14,USNTDP Juniors,USHL,4,0,1,1,2,-5,276562
2013-14,U.S. National U18 Team,USDP,4,0,1,1,2,,276562
2013-14,London Knights,OHL,33,3,4,7,45,11,276562
2013-14,London Knights,M-Cup,3,0,1,1,0,0,276562
2013-14,Owen Sound Attack,OHL,40,9,9,18,41,-9,189413
2013-14,Djurgårdens IF J18,J18 Elit,1,0,0,0,0,1,114812
2013-14,Djurgårdens IF J18,J18 Allsvenskan,2,0,1,1,0,3,114812
2013-14,Djurgårdens IF J20,SuperElit,33,1,8,9,42,2,114812
2013-14,Djurgårdens IF,Allsvenskan,6,0,2,2,4,3,114812
2013-14,Sweden U18,WJC-18,7,1,2,3,4,2,114812
2013-14,Sweden U18 (all),International-Jr,16,1,2,3,22,6,114812
2013-14,Sweden U18,Hlinka Memorial,4,0,0,0,2,4,114812
2013-14,Lévis Commandeurs,QMAAA,21,12,23,35,12,,213830
2013-14,Victoriaville Tigres,QMJHL,25,4,10,14,0,4,213830
2013-14,Aurora Tigers,OJHL,41,17,47,64,16,,146580
2013-14,Plymouth Whalers,OHL,56,18,19,37,59,-4,117000
2013-14,MODO Hockey J20,SuperElit,44,32,21,53,16,13,86308
2013-14,MODO Hockey,SHL,11,0,0,0,0,0,86308
2013-14,Sweden U19 (all),International-Jr,4,1,1,2,0,3,86308
2013-14,MODO Hockey J20,U20 Super Challenge,5,5,1,6,0,5,86308
2013-14,Victoria Royals,WHL,70,34,23,57,114,18,93438
2013-14,Cape Breton Screaming Eagles,QMJHL,65,35,47,82,51,3,90353
2013-14,Prince Albert Raiders,WHL,55,5,4,9,69,-7,62280
2013-14,Sault Ste. Marie Greyhounds,OHL,63,7,18,25,28,6,205495
2013-14,Frölunda HC J18,J18 Elit,9,6,18,24,6,16,147720
2013-14,Frölunda HC J18,J18 Allsvenskan,7,5,7,12,2,4,147720
2013-14,Frölunda HC J20,SuperElit,39,17,18,35,42,21,147720
2013-14,IF Troja-Ljungby,Allsvenskan,1,0,0,0,0,0,147720
2013-14,Sweden U18 (all),International-Jr,6,3,0,3,0,0,147720
2013-14,Frölunda HC J20,JCWC,4,0,1,1,2,1,147720
2013-14,Carleton Place Canadians,CCHL,56,17,43,60,12,,152175
2013-14,Canada East U19,WJAC-19,4,2,2,4,12,,152175
2013-14,Carleton Place Canadians,Fred Page Cup,3,0,1,1,0,1,152175
2013-14,Carleton Place Canadians,RBC Cup,6,0,2,2,2,,152175
2013-14,Rouyn-Noranda Huskies,QMJHL,68,16,39,55,32,-3,151539
2013-14,USNTDP Juniors,USHL,16,0,0,0,10,-3,122120
2013-14,U.S. National U18 Team,USDP,45,2,4,6,26,1,122120
2013-14,USA U18,WJC-18,7,1,0,1,2,1,122120
2013-14,Langley Rivermen,BCHL,54,29,20,49,30,,146215
2013-14,Edmonton Oil Kings,WHL,66,30,30,60,57,34,52421
2013-14,Latvia U20,WJC-20 D1A,5,1,6,7,2,0,52421
2013-14,Latvia U20 (all),International-Jr,8,3,9,12,4,,52421
2013-14,Edmonton Oil Kings,M-Cup,5,4,3,7,4,3,52421
2013-14,Frölunda HC J18,J18 Elit,1,1,3,4,2,4,146825
2013-14,Frölunda HC J18,J18 Allsvenskan,4,3,2,5,6,0,146825
2013-14,Frölunda HC J20,SuperElit,44,13,22,35,34,23,146825
2013-14,Frölunda HC,SHL,2,0,1,1,0,0,146825
2013-14,Sweden U18,WJC-18,7,1,2,3,27,1,146825
2013-14,Sweden U18 (all),International-Jr,20,4,4,8,31,1,146825
2013-14,Frölunda HC J20,JCWC,4,1,1,2,10,1,146825
2013-14,Sweden U18,Hlinka Memorial,4,2,0,2,2,2,146825
2013-14,Windsor Spitfires,OHL,64,1,7,8,82,-21,189460
2013-14,Skellefteå AIK J18,J18 Allsvenskan,0,0,0,0,0,0,86320
2013-14,Skellefteå AIK J20,SuperElit,33,15,23,38,12,18,86320
2013-14,Skellefteå AIK,SHL,4,0,0,0,0,-2,86320
2013-14,Sweden U18,WJC-18,7,3,8,11,4,8,86320
2013-14,Sweden U18 (all),International-Jr,16,5,13,18,6,9,86320
2013-14,Sweden U18,Hlinka Memorial,4,0,1,1,2,1,86320
2013-14,Saint John Sea Dogs,QMJHL,56,7,26,33,58,-15,151757
2013-14,Linköping HC J20,SuperElit,7,2,4,6,29,2,28988
2013-14,Linköping HC,SHL,48,0,1,1,30,-8,28988
2013-14,Sweden U20,WJC-20,6,0,0,0,14,6,28988
2013-14,Sweden U20 (all),International-Jr,16,0,2,2,26,6,28988
2013-14,Linköping HC,ET,7,0,0,0,10,,28988
2013-14,HC Kometa Brno U18,Czech U18,0,0,0,0,0,,112375
2013-14,HC Kometa Brno U20,Czech U20,26,13,6,19,35,-1,112375
2013-14,HC Kometa Brno,Czech,29,2,0,2,4,-2,112375
2013-14,Czech Republic U18 (all),International-Jr,22,6,3,9,20,-4,112375
2013-14,HC Kometa Brno,ET,7,1,0,1,0,,112375
2013-14,Czech Republic U18,Hlinka Memorial,4,2,1,3,0,0,112375
2013-14,Czech Republic U18/19,WJAC-19,4,2,0,2,2,,112375
2013-14,Red Deer Rebels,WHL,45,10,13,23,76,-6,48665
2013-14,Atlant Mytishchi,KHL,54,8,15,23,24,17,94663
2013-14,Atlanty Mytishchi,MHL,1,1,0,1,2,1,94663
2013-14,Atlant Mytishchi,Nadezhda Cup,3,0,0,0,0,-4,94663
2013-14,Indiana Ice,USHL,52,24,20,44,58,31,191247
2013-14,Union College,NCAA,41,3,13,16,18,21,122684
2013-14,Rouyn-Noranda Huskies,QMJHL,68,14,20,34,18,2,151707
2013-14,KLH Chomutov U20,Czech U20,7,5,10,15,12,14,165006
2013-14,Piráti Chomutov,Czech,37,4,3,7,10,-4,165006
2013-14,Piráti Chomutov,Czech Q,-,-,-,-,-,,165006
2013-14,SK Kadan,Czech2,5,3,1,4,0,0,165006
2013-14,Czech Republic U20,WJC-20,5,1,2,3,0,-3,165006
2013-14,Czech Republic U20 (all),International-Jr,11,3,5,8,2,-2,165006
2013-14,Piráti Chomutov,ET,8,1,0,1,0,,165006
2013-14,HV71 J18,J18 Elit,3,0,1,1,10,4,79498
2013-14,HV71 J18,J18 Allsvenskan,3,2,2,4,10,2,79498
2013-14,HV71 J20,SuperElit,42,2,7,9,28,7,79498
2013-14,Sweden U18 (all),International-Jr,13,1,1,2,10,4,79498
2013-14,Sweden U18,Hlinka Memorial,4,0,1,1,6,4,79498
2013-14,St. Michael's Buzzers,OJHL,49,16,47,63,79,,152048
2013-14,Canada East U19,WJAC-19,4,1,1,2,2,,152048
2013-14,Penticton Vees,BCHL,57,9,16,25,27,,195477
2013-14,Kingston Frontenacs,OHL,65,33,35,68,16,31,189462
2013-14,Canada U18,Hlinka Memorial,5,4,6,10,27,4,189462
2013-14,Ottawa 67's,OHL,65,2,21,23,64,-21,150872
2014-15,Erie Otters,OHL,47,44,76,120,48,60,183442
2014-15,Canada U20,WJC-20,7,3,8,11,0,8,183442
2014-15,Boston Univ.,NCAA,40,26,45,71,28,51,191959
2014-15,USA U20,WJC-20,5,1,3,4,6,-3,191959
2014-15,USA,WC,10,2,5,7,8,2,191959
2014-15,Erie Otters,OHL,68,45,84,129,32,47,228107
2014-15,Team Red,U18-Dev,3,3,0,3,0,,228107
2014-15,OHL All-Stars,Jr Super Series,1,0,0,0,0,0,228107
2014-15,Canada U18,Hlinka Memorial,5,5,1,6,0,4,228107
2014-15,London Knights,OHL,63,44,82,126,53,36,223194
2014-15,Team Red,U18-Dev,3,1,4,5,0,,223194
2014-15,Canada U18,Hlinka Memorial,5,2,5,7,6,5,223194
2014-15,OHL All-Stars,Jr Super Series,1,0,0,0,0,-1,223194
2014-15,Boston College,NCAA,37,5,18,23,16,12,177710
2014-15,USA U20,WJC-20,5,0,2,2,0,3,177710
2014-15,Sarnia Sting,OHL,37,16,18,34,56,5,130786
2014-15,Czech Republic U18,WJC-18,5,5,0,5,10,2,130786
2014-15,Czech Republic U18 (all),International-Jr,6,7,0,7,12,2,130786
2014-15,Czech Republic U20,WJC-20,5,1,1,2,0,-1,130786
2014-15,Czech Republic U20 (all),International-Jr,5,1,1,2,0,-1,130786
2014-15,Brandon Wheat Kings,WHL,60,15,46,61,42,36,242584
2014-15,Russia U20,WJC-20,7,0,1,1,0,2,242584
2014-15,Russia U20 (all),International-Jr,10,0,3,3,0,,242584
2014-15,Russian Selects,Jr Super Series,2,0,2,2,0,0,242584
2014-15,Univ. of Michigan,NCAA,35,9,16,25,8,9,186311
2014-15,USA U20,WJC-20,5,1,1,2,2,3,186311
2014-15,Halifax Mooseheads,QMJHL,61,44,46,90,59,20,95921
2014-15,Switzerland U20,WJC-20,6,2,4,6,2,2,95921
2014-15,Switzerland U20 (all),International-Jr,14,4,6,10,10,,95921
2014-15,TPS U20,Jr. A SM-liiga,0,0,0,0,0,,91186
2014-15,TPS,Liiga,56,9,19,28,22,-1,91186
2014-15,Finland U20,WJC-20,5,4,0,4,2,3,91186
2014-15,Finland U20 (all),International-Jr,10,4,0,4,6,0,91186
2014-15,Finland (all),International,4,0,0,0,0,2,91186
2014-15,TPS,Champions HL,6,2,0,2,29,0,91186
2014-15,Kingston Frontenacs,OHL,56,29,22,51,70,10,205155
2014-15,Canada U20,WJC-20,7,1,2,3,0,-1,205155
2014-15,Team White,U18-Dev,3,1,0,1,4,,205155
2014-15,OHL All-Stars,Jr Super Series,1,0,0,0,0,0,205155
2014-15,Canada U18,Hlinka Memorial,5,6,0,6,8,7,205155
2014-15,Lada Togliatti,KHL,8,0,1,1,2,-1,263964
2014-15,Ladia Togliatti,MHL,23,15,10,25,39,4,263964
2014-15,Russia U18,WJC-18,5,6,1,7,4,3,263964
2014-15,Russia U18 (all),International-Jr,12,7,1,8,33,,263964
2014-15,Russia U19,WJAC-19,5,3,1,4,2,,263964
2014-15,Saint John Sea Dogs,QMJHL,44,13,20,33,73,2,112379
2014-15,Czech Republic U18,WJC-18,3,1,1,2,4,2,112379
2014-15,Czech Republic U18 (all),International-Jr,9,5,5,10,14,2,112379
2014-15,Czech Republic U18,Hlinka Memorial,5,4,2,6,8,-1,112379
2014-15,Swift Current Broncos,WHL,72,42,39,81,40,-9,84242
2014-15,Sault Ste. Marie Greyhounds,OHL,66,26,19,45,17,30,245108
2014-15,Seattle Thunderbirds,WHL,44,12,45,57,20,13,186310
2014-15,Canada U18,WJC-18,7,3,9,12,0,2,186310
2014-15,Team White,U18-Dev,3,0,1,1,2,,186310
2014-15,Canada U18,Hlinka Memorial,5,2,5,7,0,5,186310
2014-15,Youngstown Phantoms,USHL,56,34,46,80,6,3,177671
2014-15,USA U19,WJAC-19,4,1,1,2,0,,177671
2014-15,Saint John Sea Dogs,QMJHL,66,12,29,41,62,6,213607
2014-15,Canada U18,WJC-18,7,1,4,5,0,1,213607
2014-15,Cape Breton Screaming Eagles,QMJHL,55,32,46,78,70,19,168679
2014-15,Russia U20 (all),International-Jr,2,0,0,0,0,,168679
2014-15,Cape Breton Screaming Eagles,JCWC,4,2,2,4,14,1,168679
2014-15,Russian Selects,Jr Super Series,2,0,0,0,0,0,168679
2014-15,Färjestad BK J20,SuperElit,25,21,11,32,20,13,139633
2014-15,Färjestad BK,SHL,34,4,2,6,4,0,139633
2014-15,Sweden U18,WJC-18,5,5,1,6,2,-4,139633
2014-15,Sweden U18 (all),International-Jr,19,15,7,22,10,-2,139633
2014-15,Färjestad BK,Champions HL,1,0,0,0,0,0,139633
2014-15,Sweden U18,Hlinka Memorial,5,3,1,4,0,2,139633
2014-15,USNTDP Juniors,USHL,20,4,13,17,10,17,183810
2014-15,U.S. National U18 Team,USDP,54,23,31,54,28,,183810
2014-15,USA U18,WJC-18,7,6,3,9,0,8,183810
2014-15,Waterloo Black Hawks,USHL,57,35,33,68,30,-1,248381
2014-15,Team Red,USA-S17,5,2,4,6,-,,248381
2014-15,USA U18,Hlinka Memorial,5,6,2,8,10,6,248381
2014-15,USA U19,WJAC-19,4,4,1,5,6,,248381
2014-15,Ottawa 67's,OHL,60,29,39,68,34,-1,205148
2014-15,Team White,U18-Dev,3,1,1,2,0,,205148
2014-15,OHL All-Stars,Jr Super Series,1,0,0,0,0,0,205148
2014-15,Canada U18,Hlinka Memorial,5,5,1,6,2,3,205148
2014-15,USNTDP Juniors,USHL,25,11,27,38,8,19,226309
2014-15,U.S. National U18 Team,USDP,65,27,52,79,28,,226309
2014-15,USA U18,WJC-18,7,6,5,11,4,11,226309
2014-15,Everett Silvertips,WHL,68,9,43,52,42,22,199905
2014-15,Team Red,U18-Dev,2,0,1,1,0,,199905
2014-15,Frölunda HC J18,J18 Elit,1,0,0,0,0,-2,147719
2014-15,Frölunda HC J18,J18 Allsvenskan,2,1,1,2,0,2,147719
2014-15,Frölunda HC J20,SuperElit,30,8,11,19,49,7,147719
2014-15,Frölunda HC,SHL,20,1,2,3,6,4,147719
2014-15,Sweden U18,WJC-18,5,0,3,3,0,-1,147719
2014-15,Sweden U18 (all),International-Jr,20,0,9,9,14,-2,147719
2014-15,Frölunda HC,Champions HL,5,0,0,0,2,1,147719
2014-15,Sweden U18,Hlinka Memorial,5,0,1,1,2,-2,147719
2014-15,Shawinigan Cataractes,QMJHL,67,42,52,94,72,16,213435
2014-15,Canada U18,WJC-18,6,3,0,3,2,0,213435
2014-15,Team Red,U18-Dev,3,2,1,3,2,,213435
2014-15,QMJHL All-Stars,Jr Super Series,2,0,0,0,2,-1,213435
2014-15,Canada U18,Hlinka Memorial,3,0,0,0,0,1,213435
2014-15,Linköping HC J18,J18 Elit,3,2,0,2,0,2,187919
2014-15,Linköping HC J18,J18 Allsvenskan,4,0,3,3,2,0,187919
2014-15,Linköping HC J20,SuperElit,39,0,7,7,14,21,187919
2014-15,Linköping HC,SHL,7,0,2,2,0,3,187919
2014-15,Sweden U18,WJC-18,5,0,0,0,2,0,187919
2014-15,Sweden U18 (all),International-Jr,20,0,2,2,4,3,187919
2014-15,Sweden U18,Hlinka Memorial,5,0,1,1,0,5,187919
2014-15,Kelowna Rockets,WHL,72,20,70,90,79,29,107894
2014-15,Team White,U18-Dev,3,0,1,1,6,,107894
2014-15,Canada U18,Hlinka Memorial,5,0,4,4,8,9,107894
2014-15,Kelowna Rockets,M-Cup,5,3,2,5,14,1,107894
2014-15,Sherbrooke Phoenix,QMJHL,46,5,38,43,37,-2,151150
2014-15,Canada U18,WJC-18,7,3,1,4,2,-6,151150
2014-15,Team White,U18-Dev,3,1,0,1,0,,151150
2014-15,Canada U18,Hlinka Memorial,5,0,3,3,4,8,151150
2014-15,USNTDP Juniors,USHL,25,15,15,30,10,16,226901
2014-15,U.S. National U18 Team,USDP,66,31,33,64,22,,226901
2014-15,USA U18,WJC-18,7,1,7,8,0,2,226901
2014-15,Saginaw Spirit,OHL,62,22,26,48,44,-17,186392
2014-15,Canada U18,WJC-18,7,5,5,10,10,1,186392
2014-15,Team Red,U18-Dev,3,2,1,3,0,,186392
2014-15,Canada U18,Hlinka Memorial,5,4,2,6,2,9,186392
2014-15,Erie Otters,OHL,61,8,37,45,53,23,214673
2014-15,Kärpät U20,Jr. A SM-liiga,10,1,9,10,4,2,152111
2014-15,Kärpät,Liiga,27,4,7,11,10,4,152111
2014-15,Ässät,Liiga,3,0,2,2,0,2,152111
2014-15,Finland U18,WJC-18,1,0,1,1,0,1,152111
2014-15,Finland U18 (all),International-Jr,9,6,3,9,6,-4,152111
2014-15,Finland U20,WJC-20,5,0,0,0,2,-1,152111
2014-15,Finland U20 (all),International-Jr,13,3,4,7,2,5,152111
2014-15,Kärpät,Champions HL,7,0,1,1,2,3,152111
2014-15,Finland U18,Hlinka Memorial,4,5,2,7,0,2,152111
2014-15,Victoriaville Tigres,QMJHL,67,35,24,59,39,2,156103
2014-15,Tri-City Americans,WHL,63,4,21,25,90,-15,120965
2014-15,USA U20,WJC-20,5,0,1,1,0,1,120965
2014-15,Portland Winterhawks,WHL,66,34,37,71,52,39,216874
2014-15,Boston Univ.,NCAA,37,3,4,7,18,1,151125
2014-15,Baie-Comeau Drakkar,QMJHL,44,10,24,34,99,-3,213821
2014-15,Team Red,U18-Dev,3,0,0,0,4,,213821
2014-15,QMJHL All-Stars,Jr Super Series,2,1,0,1,8,1,213821
2014-15,Canada U18,Hlinka Memorial,5,0,1,1,6,6,213821
2014-15,Seattle Thunderbirds,WHL,67,30,28,58,44,9,120198
2014-15,HC Kosice,Slovakia,43,5,8,13,16,7,166368
2014-15,Slovakia U20,WJC-20,6,0,2,2,4,1,166368
2014-15,Slovakia U20 (all),International-Jr,5,3,2,5,8,2,166368
2014-15,Slovakia (all),International,3,1,0,1,6,2,166368
2014-15,HC Kosice,Champions HL,6,0,1,1,4,-2,166368
2014-15,Peterborough Petes,OHL,67,6,24,30,64,-15,225188
2014-15,Canada U18,WJC-18,7,0,2,2,4,2,225188
2014-15,Team White,U18-Dev,3,0,0,0,0,,225188
2014-15,Canada U18,Hlinka Memorial,5,0,2,2,2,5,225188
2014-15,OHL All-Stars,Jr Super Series,1,0,0,0,0,-2,225188
2014-15,Omaha Lancers,USHL,50,15,38,53,38,10,115158
2014-15,Sweden U20 (all),International-Jr,5,0,0,0,4,0,115158
2014-15,Charlottetown Islanders,QMJHL,68,39,49,88,18,-23,231299
2014-15,Prince George Cougars,WHL,70,20,59,79,45,7,160158
2014-15,Canada U18,WJC-18,7,3,2,5,10,3,160158
2014-15,Team White,U18-Dev,3,0,1,1,2,,160158
2014-15,Canada U18,Hlinka Memorial,5,2,4,6,0,3,160158
2014-15,Charlottetown Islanders,QMJHL,64,33,42,75,42,-16,157524
2014-15,Czech Republic U18,WJC-18,3,0,0,0,2,0,157524
2014-15,Czech Republic U18 (all),International-Jr,8,1,4,5,4,-1,157524
2014-15,Czech Republic U18,Hlinka Memorial,5,1,4,5,2,-1,157524
2014-15,Ilves U20,Jr. A SM-liiga,0,0,0,0,0,,92117
2014-15,Ilves,Liiga,42,5,12,17,10,8,92117
2014-15,Finland U20,WJC-20,5,0,2,2,2,3,92117
2014-15,Finland U20 (all),International-Jr,20,6,4,10,4,6,92117
2014-15,USNTDP Juniors,USHL,22,5,15,20,16,15,183455
2014-15,U.S. National U18 Team,USDP,53,9,34,43,50,,183455
2014-15,USA U18,WJC-18,7,1,6,7,4,6,183455
2014-15,Prince Albert Raiders,WHL,72,5,27,32,36,-6,63250
2014-15,Rouyn-Noranda Huskies,QMJHL,60,15,21,36,88,12,213715
2014-15,Barrie Colts,OHL,67,12,52,64,88,14,86137
2014-15,Niagara IceDogs,OHL,59,25,18,43,33,1,225057
2014-15,Canada U18,WJC-18,5,1,3,4,4,0,225057
2014-15,Team Red,U18-Dev,3,1,1,2,2,,225057
2014-15,Canada U18,Hlinka Memorial,5,0,4,4,0,2,225057
2014-15,Gatineau Olympiques,QMJHL,58,18,49,67,34,17,277485
2014-15,Russia U19 (all),International-Jr,2,0,0,0,2,1,277485
2014-15,Niagara IceDogs,OHL,68,18,38,56,59,8,161816
2014-15,ZSC Lions,NLA,41,0,3,3,39,4,105407
2014-15,GC Küsnacht Lions,NLB,10,1,7,8,10,,105407
2014-15,Switzerland U18,WJC-18,7,0,4,4,20,2,105407
2014-15,Switzerland U18 (all),International-Jr,7,0,4,4,20,,105407
2014-15,Switzerland U20,WJC-20,6,0,1,1,8,9,105407
2014-15,Switzerland U20 (all),International-Jr,12,0,1,1,12,,105407
2014-15,ZSC Lions,Champions HL,4,0,0,0,6,,105407
2014-15,ZSC Lions,Swiss Cup,1,0,0,0,0,,105407
2014-15,HV71 J20,SuperElit,36,14,22,36,16,4,142262
2014-15,HV71,SHL,17,1,0,1,2,-3,142262
2014-15,Sweden U19 (all),International-Jr,4,0,3,3,0,2,142262
2014-15,JYP,Liiga,9,0,3,3,0,0,85961
2014-15,JYP-Akatemia,Mestis,39,11,18,29,8,9,85961
2014-15,Finland U18,WJC-18,7,2,2,4,2,-1,85961
2014-15,Finland U18 (all),International-Jr,23,11,20,31,10,3,85961
2014-15,JYP,Champions HL,4,0,0,0,0,0,85961
2014-15,Finland U18,Hlinka Memorial,4,1,6,7,0,1,85961
2014-15,Färjestad BK J20,SuperElit,10,4,3,7,2,-1,142238
2014-15,Färjestad BK,SHL,18,2,3,5,4,-2,142238
2014-15,AIK,Allsvenskan,17,4,3,7,6,-2,142238
2014-15,Sweden U18,WJC-18,5,0,2,2,4,-7,142238
2014-15,Sweden U18 (all),International-Jr,16,1,6,7,10,-2,142238
2014-15,Sweden U20 (all),International-Jr,5,0,0,0,2,-2,142238
2014-15,Färjestad BK,Champions HL,6,0,0,0,2,0,142238
2014-15,Sweden U18,Hlinka Memorial,5,1,2,3,2,5,142238
2014-15,USNTDP Juniors,USHL,24,14,18,32,6,20,197800
2014-15,U.S. National U18 Team,USDP,65,30,64,94,10,,197800
2014-15,USA U18,WJC-18,7,3,10,13,2,10,197800
2014-15,AIK J20,SuperElit,9,5,5,10,8,5,85693
2014-15,AIK,Allsvenskan,52,17,11,28,63,-6,85693
2014-15,Sweden U19 (all),International-Jr,4,4,2,6,2,2,85693
2014-15,Sudbury Wolves,OHL,68,10,30,40,54,-49,225186
2014-15,Canada U18,WJC-18,7,1,1,2,2,2,225186
2014-15,Shawinigan Cataractes,QMJHL,59,33,31,64,71,23,183259
2014-15,Team Red,USA-S17,5,6,1,7,-,,183259
2014-15,USA U18,Hlinka Memorial,5,4,4,8,4,4,183259
2014-15,Lethbridge Hurricanes,WHL,59,7,17,24,101,-9,131262
2014-15,Acadie-Bathurst Titan,QMJHL,63,4,24,28,34,-40,213397
2014-15,Canada U18,WJC-18,7,1,0,1,2,-5,213397
2014-15,Team Red,U18-Dev,3,0,0,0,0,,213397
2014-15,QMJHL All-Stars,Jr Super Series,1,0,0,0,0,1,213397
2014-15,Canada U18,Hlinka Memorial,5,0,3,3,4,8,213397
2014-15,Sault Ste. Marie Greyhounds,OHL,57,24,43,67,12,25,186413
2014-15,Team White,U18-Dev,3,1,0,1,0,,186413
2014-15,Ogre/Saga 18,Latvia,6,5,5,10,12,,239362
2014-15,HK Riga,MHL,32,10,18,28,49,3,239362
2014-15,Latvia U18,WJC-18,6,3,6,9,10,2,239362
2014-15,Latvia U18 (all),International-Jr,7,3,9,12,12,,239362
2014-15,Latvia U20,WJC-20 D1A,5,2,2,4,2,2,239362
2014-15,Latvia U20 (all),International-Jr,10,4,4,8,4,,239362
2014-15,Seattle Thunderbirds,WHL,64,19,19,38,85,-7,197560
2014-15,Rouyn-Noranda Huskies,QMJHL,68,14,39,53,29,16,204169
2014-15,Oshawa Generals,OHL,68,13,23,36,22,34,274875
2014-15,Oshawa Generals,M-Cup,4,2,1,3,0,3,274875
2014-15,Green Bay Gamblers,USHL,57,6,17,23,14,-3,122954
2014-15,Finland U18,WJC-18,7,3,6,9,4,2,122954
2014-15,Finland U18 (all),International-Jr,12,4,8,12,6,2,122954
2014-15,Finland U18,Hlinka Memorial,4,1,3,4,2,-1,122954
2014-15,SKA-1946 St. Petersburg,MHL,45,10,29,39,52,5,231966
2014-15,Russia U20,WJC-20,7,1,3,4,2,2,231966
2014-15,Russia U20 (all),International-Jr,13,1,5,6,2,,231966
2014-15,Russian Selects,Jr Super Series,6,0,2,2,0,0,231966
2014-15,Cedar Rapids RoughRiders,USHL,55,27,27,54,80,12,212561
2014-15,Team Orange,USA-S17,5,3,3,6,-,,212561
2014-15,USA U18,Hlinka Memorial,5,2,1,3,4,2,212561
2014-15,Regina Pats,WHL,71,3,16,19,70,15,277798
2014-15,Green Bay Gamblers,USHL,33,10,17,27,18,-9,208974
2014-15,Team Kelly,USA-S17,5,2,3,5,-,,208974
2014-15,USA U18,Hlinka Memorial,1,0,0,0,0,-1,208974
2014-15,USNTDP Juniors,USHL,20,7,6,13,33,5,208973
2014-15,U.S. National U18 Team,USDP,61,19,19,38,49,,208973
2014-15,USA U18,WJC-18,7,2,2,4,0,6,208973
2014-15,Oshawa Generals,OHL,58,12,51,63,38,31,204918
2014-15,Team Red,U18-Dev,3,0,1,1,0,,204918
2014-15,OHL All-Stars,Jr Super Series,2,0,1,1,0,-1,204918
2014-15,Oshawa Generals,M-Cup,4,0,2,2,0,0,204918
2014-15,Canada U18,Hlinka Memorial,4,1,1,2,0,4,204918
2014-15,Brynäs IF J18,J18 Allsvenskan,1,1,4,5,0,3,146691
2014-15,Brynäs IF J20,SuperElit,18,10,8,18,4,18,146691
2014-15,Brynäs IF,SHL,43,2,4,6,2,-4,146691
2014-15,Sweden U18,WJC-18,4,0,0,0,2,-1,146691
2014-15,Sweden U18 (all),International-Jr,15,1,6,7,6,2,146691
2014-15,Sweden U20,WJC-20,7,3,0,3,0,-1,146691
2014-15,Sweden U20 (all),International-Jr,8,4,0,4,0,-1,146691
2014-15,Sweden U18,Hlinka Memorial,5,0,4,4,2,2,146691
2014-15,Kamloops Blazers,WHL,64,17,25,42,25,18,202370
2014-15,Canada U18,WJC-18,7,3,1,4,12,0,202370
2014-15,Waterloo Black Hawks,USHL,46,14,34,48,12,14,248374
2014-15,Team Gold,USA-S17,5,0,2,2,-,,248374
2014-15,USA U18,Hlinka Memorial,5,5,6,11,2,6,248374
2014-15,USA U19,WJAC-19,4,3,4,7,0,,248374
2014-15,Djurgårdens IF J20,SuperElit,34,23,25,48,51,28,142243
2014-15,Djurgårdens IF,SHL,3,0,0,0,0,0,142243
2014-15,Owen Sound Attack,OHL,68,14,35,49,36,0,232612
2014-15,Ässät,Liiga,51,6,6,12,18,-7,94117
2014-15,Finland U18,WJC-18,7,3,5,8,6,6,94117
2014-15,Finland U18 (all),International-Jr,8,3,6,9,6,6,94117
2014-15,Finland U20 (all),International-Jr,7,0,0,0,2,,94117
2014-15,Chicago Steel,USHL,59,4,23,27,89,2,267396
2014-15,Moorhead High,USHS-MN,24,5,21,26,64,,248330
2014-15,Great Plains,USHS-MN,17,1,6,7,41,,248330
2014-15,Omaha Lancers,USHL,18,1,5,6,0,-2,248330
2014-15,Red Deer Rebels,WHL,66,15,24,39,71,-7,189422
2014-15,Team Red,U18-Dev,3,0,0,0,0,,189422
2014-15,Canada U18,Hlinka Memorial,5,1,2,3,8,2,189422
2014-15,MODO Hockey J18,J18 Elit,1,0,1,1,2,1,187806
2014-15,MODO Hockey J18,J18 Allsvenskan,5,0,8,8,6,0,187806
2014-15,MODO Hockey J20,SuperElit,39,6,27,33,39,11,187806
2014-15,MODO Hockey,SHL,4,0,1,1,0,0,187806
2014-15,Sweden U18,WJC-18,5,1,1,2,0,-2,187806
2014-15,Sweden U18 (all),International-Jr,15,1,2,3,6,-2,187806
2014-15,Chicoutimi Saguenéens,QMJHL,68,16,34,50,40,-3,151361
2014-15,Canada U18,WJC-18,7,3,3,6,6,2,151361
2014-15,Team Red,U18-Dev,3,1,2,3,2,,151361
2014-15,QMJHL All-Stars,Jr Super Series,2,0,0,0,0,-1,151361
2014-15,Canada U18,Hlinka Memorial,5,1,4,5,2,8,151361
2014-15,Sault Ste. Marie Greyhounds,OHL,67,6,16,22,30,38,204911
2014-15,Saint John Sea Dogs,QMJHL,66,14,20,34,73,12,135860
2014-15,Regina Pats,WHL,61,20,19,39,53,13,161117
2014-15,Val-d'Or Foreurs,QMJHL,66,43,48,91,78,-9,155661
2014-15,QMJHL All-Stars,Jr Super Series,2,1,0,1,0,2,155661
2014-15,Dynamo Moskva,KHL,52,5,3,8,20,-4,159421
2014-15,Dynamo Balashikha,VHL,1,0,0,0,2,0,159421
2014-15,Russia,EHT,9,0,1,1,14,-3,159421
2014-15,Russia,WC,8,0,1,1,2,-1,159421
2014-15,Russia (all),International,20,0,2,2,20,,159421
2014-15,GCK Lions U20,Elite Jr. A,0,0,0,0,0,,117376
2014-15,GC Küsnacht Lions,NLB,24,6,6,12,4,,117376
2014-15,ZSC Lions,NLA,23,2,6,8,8,4,117376
2014-15,Switzerland U18,WJC-18,7,3,2,5,2,0,117376
2014-15,Switzerland U18 (all),International-Jr,7,3,2,5,2,,117376
2014-15,Switzerland U20,WJC-20,6,1,6,7,0,6,117376
2014-15,Switzerland U20 (all),International-Jr,16,7,9,16,2,,117376
2014-15,GC Küsnacht Lions,Swiss Cup,1,0,0,0,0,,117376
2014-15,ZSC Lions,Champions HL,1,0,0,0,0,-1,117376
2014-15,London Knights,OHL,64,7,9,16,49,4,226615
2014-15,Tolpar Ufa,MHL,39,8,12,20,40,8,285679
2014-15,Russia U18,WJC-18,5,1,3,4,2,6,285679
2014-15,Russia U18 (all),International-Jr,12,2,2,4,8,,285679
2014-15,Russia U19,WJAC-19,5,1,1,2,2,,285679
2014-15,Brandon Wheat Kings,WHL,33,13,12,25,69,10,199921
2014-15,Regina Pats,WHL,33,10,9,19,43,-8,199921
2014-15,Spokane Chiefs,WHL,69,44,43,87,59,10,119394
2014-15,Muskegon Lumberjacks,USHL,56,14,27,41,107,14,188788
2014-15,USA U19,WJAC-19,4,0,4,4,4,,188788
2014-15,HC Pardubice U18,Czech U18,0,0,0,0,0,,199564
2014-15,HC Pardubice U20,Czech U20,5,2,5,7,38,0,199564
2014-15,HC Pardubice,Czech,40,5,7,12,12,-11,199564
2014-15,Czech Republic U18,WJC-18,5,1,4,5,0,3,199564
2014-15,Czech Republic U18 (all),International-Jr,12,3,10,13,4,3,199564
2014-15,Czech Republic U20,WJC-20,5,0,1,1,2,2,199564
2014-15,Czech Republic U20 (all),International-Jr,5,0,1,1,2,2,199564
2014-15,HC Pardubice,Champions HL,3,0,0,0,2,-2,199564
2014-15,HV71 J18,J18 Elit,1,0,1,1,0,0,162177
2014-15,HV71 J18,J18 Allsvenskan,0,0,0,0,0,,162177
2014-15,HV71 J20,SuperElit,34,20,22,42,53,5,162177
2014-15,HV71,SHL,15,0,2,2,2,-2,162177
2014-15,Sweden U18,WJC-18,5,0,3,3,16,-6,162177
2014-15,Sweden U18 (all),International-Jr,20,3,9,12,55,-7,162177
2014-15,Sweden U18,Hlinka Memorial,5,0,2,2,27,0,162177
2014-15,Tri-City Americans,WHL,72,9,33,42,93,-13,195951
2014-15,Canada U18,WJC-18,7,1,4,5,6,9,195951
2014-15,Team Red,U18-Dev,3,0,1,1,0,,195951
2014-15,Prince George Cougars,WHL,67,23,26,49,30,-3,199394
2014-15,Omskie Yastreby,MHL,35,3,16,19,42,-1,277804
2014-15,Russia U18,WJC-18,5,3,3,6,2,1,277804
2014-15,Russia U18 (all),International-Jr,16,6,10,16,58,,277804
2014-15,Russia U18,Hlinka Memorial,4,1,4,5,16,-3,277804
2014-15,Russia U19,WJAC-19,5,1,3,4,4,,277804
2014-15,Gatineau Olympiques,QMJHL,68,12,43,55,64,17,151143
2014-15,QMJHL All-Stars,Jr Super Series,2,0,2,2,2,-1,151143
2014-15,Swift Current Broncos,WHL,72,15,39,54,59,-9,192245
2014-15,Canada U18,WJC-18,7,2,2,4,4,2,192245
2014-15,Team Red,U18-Dev,3,0,0,0,0,,192245
2014-15,USNTDP Juniors,USHL,25,2,6,8,28,14,199902
2014-15,U.S. National U18 Team,USDP,65,6,19,25,50,,199902
2014-15,USA U18,WJC-18,7,0,5,5,0,6,199902
2014-15,KalPa U20,Jr. A SM-liiga,26,11,16,27,26,3,131138
2014-15,KalPa,Liiga,32,4,0,4,6,3,131138
2014-15,Finland U18,WJC-18,7,1,4,5,4,-1,131138
2014-15,Finland U18 (all),International-Jr,23,7,18,25,16,6,131138
2014-15,KalPa,Champions HL,3,0,0,0,0,-1,131138
2014-15,Finland U18,Hlinka Memorial,4,1,0,1,4,3,131138
2014-15,Djurgårdens IF J20,SuperElit,44,26,35,61,22,23,142253
2014-15,Djurgårdens IF,SHL,2,0,0,0,0,-3,142253
2014-15,Sweden U19 (all),International-Jr,4,1,4,5,4,0,142253
2014-15,Saint John Sea Dogs,QMJHL,59,21,21,42,46,18,227640
2014-15,Boston College High,USHS-Prep,22,6,29,35,-,,232931
2014-15,Cape Cod Whalers U18,MHSL U18,14,3,6,9,0,,232931
2014-15,Youngstown Phantoms,USHL,2,0,0,0,0,-2,232931
2014-15,Team White,USA-S17,5,0,3,3,-,,232931
2014-15,Kelowna Rockets,WHL,64,4,7,11,33,17,268073
2014-15,Kelowna Rockets,M-Cup,5,0,0,0,0,2,268073
2014-15,Moncton Wildcats,QMJHL,67,35,94,129,66,21,177208
2014-15,Seattle Thunderbirds,WHL,69,13,25,38,23,1,197561
2014-15,Canada U18,WJC-18,7,0,3,3,6,7,197561
2014-15,Team White,U18-Dev,3,0,0,0,0,,197561
2014-15,Canada U18,Hlinka Memorial,5,1,1,2,2,7,197561
2014-15,Québec Remparts,QMJHL,66,19,71,90,54,17,115161
2014-15,Québec Remparts,M-Cup,5,3,1,4,8,-2,115161
2014-15,Noble & Greenough School,USHS-Prep,23,11,18,29,-,,248399
2014-15,Cape Cod Whalers U18,MHSL U18,14,5,12,17,0,,248399
2014-15,Team White,USA-S17,5,1,3,4,-,,248399
2014-15,KalPa U20,Jr. A SM-liiga,37,9,14,23,80,7,94439
2014-15,KalPa,Liiga,10,0,1,1,4,-1,94439
2014-15,Hokki,Mestis,5,1,0,1,8,-2,94439
2014-15,Finland U20 (all),International-Jr,7,0,2,2,6,-1,94439
2014-15,KLH Chomutov U20,Czech U20,8,7,8,15,2,8,158842
2014-15,Piráti Chomutov,Czech2,30,7,7,14,10,11,158842
2014-15,Czech Republic U18,WJC-18,4,2,3,5,2,3,158842
2014-15,Czech Republic U18 (all),International-Jr,15,4,11,15,6,3,158842
2014-15,Czech Republic U20,WJC-20,4,0,1,1,0,3,158842
2014-15,Czech Republic U20 (all),International-Jr,7,1,1,2,2,2,158842
2014-15,Czech Republic U18,Hlinka Memorial,5,1,1,2,4,1,158842
2014-15,Prince George Cougars,WHL,64,3,23,26,140,3,120650
2014-15,HS Prizma/Pardaugava U18,Latvia U18,3,2,2,4,0,,214273
2014-15,HK Riga,MHL,56,7,8,15,40,-3,214273
2014-15,Latvia U18,WJC-18,6,2,4,6,8,2,214273
2014-15,Latvia U18 (all),International-Jr,7,4,5,9,10,,214273
2014-15,Latvia U20,WJC-20 D1A,5,1,2,3,2,0,214273
2014-15,Latvia U20 (all),International-Jr,10,1,4,5,8,,214273
2014-15,Latvia (all),International,1,0,0,0,0,0,214273
2014-15,HK Riga,JCWC,5,0,0,0,2,0,214273
2014-15,Medicine Hat Tigers,WHL,71,17,23,40,24,-2,199714
2014-15,Culver Military Academy Prep,USHS-Prep,32,19,24,43,10,32,245262
2014-15,U.S. National U18 Team,USDP,2,0,0,0,0,,245262
2014-15,Team Orange,USA-S17,5,3,2,5,-,,245262
2014-15,USA U18,Hlinka Memorial,5,3,1,4,4,0,245262
2014-15,Muskegon Lumberjacks,USHL,60,3,14,17,35,10,232945
2014-15,Team Orange,USA-S17,5,0,2,2,-,,232945
2014-15,USA U18,Hlinka Memorial,5,0,0,0,4,-2,232945
2014-15,Sudbury Wolves,OHL,66,24,16,40,68,-57,189373
2014-15,Metallurg Novokuznetsk,KHL,31,4,4,8,6,-4,265645
2014-15,Kuznetskie Medvedi,MHL,3,0,2,2,2,1,265645
2014-15,Russia U18,WJC-18,4,1,3,4,2,0,265645
2014-15,Russia U18 (all),International-Jr,13,7,7,14,4,,265645
2014-15,Russia U18,Hlinka Memorial,4,5,2,7,0,1,265645
2014-15,Russia U19,WJAC-19,5,2,1,3,0,,265645
2014-15,Calgary Hitmen,WHL,69,20,22,42,51,-4,268038
2014-15,Russia U18 (all),International-Jr,4,0,1,1,2,,268038
2014-15,Russia U18,Hlinka Memorial,4,0,1,1,2,-1,268038
2014-15,HC Plzen,Czech,52,18,12,30,20,0,105831
2014-15,Czech Republic,EHT,10,2,0,2,0,3,105831
2014-15,Czech Republic,WC,10,1,5,6,2,5,105831
2014-15,Czech Republic (all),International,23,5,6,11,2,11,105831
2014-15,Saint John Sea Dogs,QMJHL,66,23,33,56,73,17,166979
2014-15,Luleå HF J20,SuperElit,23,4,8,12,74,7,166373
2014-15,Luleå HF,SHL,25,0,1,1,6,-3,166373
2014-15,Asplöven HC,Allsvenskan,6,0,1,1,0,-4,166373
2014-15,Slovakia U20,WJC-20,7,0,1,1,8,2,166373
2014-15,Slovakia U20 (all),International-Jr,7,1,2,3,20,2,166373
2014-15,Slovakia (all),International,7,0,1,1,8,3,166373
2014-15,Luleå HF,Champions HL,5,0,0,0,0,0,166373
2014-15,Youngstown Phantoms,USHL,57,12,14,26,96,9,245117
2014-15,Blues U20,Jr. A SM-liiga,42,13,31,44,42,22,104435
2014-15,Blues,Liiga,2,0,1,1,0,0,104435
2014-15,Finland U18,WJC-18,7,0,1,1,10,-1,104435
2014-15,Finland U18 (all),International-Jr,23,2,5,7,42,-3,104435
2014-15,Blues U20,JCWC,5,0,3,3,12,-3,104435
2014-15,Finland U18,Hlinka Memorial,4,0,1,1,14,0,104435
2014-15,Stavanger Oilers,Norway,36,8,13,21,8,14,153652
2014-15,Stavanger Oilers U20,Norway U20,7,6,3,9,2,3,153652
2014-15,Stavanger Oilers U18,Norway U18,0,0,0,0,0,,153652
2014-15,Latvia U18,WJC-18,6,2,4,6,2,3,153652
2014-15,Latvia U18 (all),International-Jr,10,6,7,13,6,,153652
2014-15,Latvia U20,WJC-20 D1A,5,2,0,2,4,2,153652
2014-15,Latvia U20 (all),International-Jr,10,2,5,7,6,,153652
2014-15,Stavanger Oilers,Champions HL,4,0,0,0,0,-2,153652
2014-15,Nipawin Hawks,SJHL,4,0,0,0,4,,199904
2014-15,Medicine Hat Tigers,WHL,12,1,1,2,15,1,199904
2014-15,Regina Pats,WHL,33,1,15,16,21,5,199904
2014-15,Team White,U18-Dev,3,0,1,1,0,,199904
2014-15,Canada U18,Hlinka Memorial,5,0,2,2,2,6,199904
2014-15,Canada West U19,WJAC-19,4,0,0,0,2,,199904
2014-15,Sherbrooke Phoenix,QMJHL,63,14,26,40,77,-16,151536
2014-15,Brandon Wheat Kings,WHL,68,11,41,52,40,36,119271
2014-15,USNTDP Juniors,USHL,25,6,8,14,4,3,234046
2014-15,U.S. National U18 Team,USDP,66,19,25,44,8,,234046
2014-15,USA U18,WJC-18,7,3,2,5,0,3,234046
2014-15,Team Gold,USA-S17,5,3,1,4,-,,234046
2014-15,USA U18,Hlinka Memorial,5,4,1,5,0,-1,234046
2014-15,Cedar Rapids RoughRiders,USHL,50,13,17,30,55,23,203361
2014-15,USA U19,WJAC-19,4,0,0,0,0,,203361
2014-15,Sioux City Musketeers,USHL,56,3,19,22,58,25,248447
2014-15,Team Black,USA-S17,5,1,0,1,-,,248447
2014-15,Sioux City Musketeers,JCWC,6,0,1,1,2,,248447
2014-15,USA U19,WJAC-19,4,0,2,2,2,,248447
2014-15,Team Slovakia U18,Slovakia2,17,6,6,12,47,-4,157407
2014-15,Team Slovakia U20,Slovakia,4,0,0,0,2,-2,157407
2014-15,HC Kosice,Slovakia,15,2,2,4,6,6,157407
2014-15,Slovakia U18,WJC-18,5,1,3,4,2,1,157407
2014-15,Slovakia U18 (all),International-Jr,3,2,0,2,0,1,157407
2014-15,Slovakia U20,WJC-20,7,0,0,0,2,-2,157407
2014-15,Slovakia U18,Hlinka Memorial,4,1,0,1,4,-5,157407
2014-15,Lethbridge Hurricanes,WHL,64,23,28,51,18,-1,131304
2014-15,Team Red,U18-Dev,3,0,0,0,0,,131304
2014-15,South Shore Kings,USPHL Premier,49,4,24,28,42,,278675
2014-15,Team Red,USA-S17,5,0,3,3,-,,278675
2014-15,Oshawa Generals,OHL,66,10,13,23,41,33,205526
2014-15,Oshawa Generals,M-Cup,4,2,1,3,0,2,205526
2014-15,Kimball Union Academy,USHS-Prep,34,5,15,20,-,,304382
2014-15,Boston Jr. Bruins Selects U18,MHSL U18,14,6,5,11,20,,304382
2014-15,Merrimack College,NCAA,34,11,15,26,55,3,204125
2014-15,Muskegon Lumberjacks,USHL,14,2,7,9,4,-3,248334
2014-15,Sioux Falls Stampede,USHL,38,20,29,49,28,4,248334
2014-15,Lokomotiv Yaroslavl,KHL,16,0,1,1,4,3,165015
2014-15,Loko Yaroslavl,MHL,16,1,6,7,16,7,165015
2014-15,HK Ryazan,VHL,11,1,2,3,4,3,165015
2014-15,Russia U20,WJC-20,7,0,0,0,0,-2,165015
2014-15,Russia U20 (all),International-Jr,20,1,2,3,4,,165015
2014-15,Russia,EHT,2,0,0,0,0,1,165015
2014-15,Russia (all),International,4,0,0,0,0,,165015
2014-15,Russian Selects,Jr Super Series,6,0,1,1,4,3,165015
2014-15,Team Wisconsin,USHS-WI,18,3,1,4,16,,245310
2014-15,Wausau West High,USHS-WI,23,7,15,22,28,,245310
2014-15,Green Bay Gamblers,USHL,3,0,0,0,0,-1,245310
2014-15,Team Orange,USA-S17,5,0,0,0,-,,245310
2014-15,Drummondville Voltigeurs,QMJHL,64,3,18,21,64,11,218306
2014-15,Tri-City Storm,USHL,59,35,20,55,66,4,120644
2014-15,Barrie Colts,OHL,64,9,9,18,29,-5,232637
2014-15,Univ. of Wisconsin,NCAA,34,3,10,13,35,-17,62155
2014-15,Barrie Colts,OHL,68,43,61,104,54,24,223199
2014-15,Western Michigan Univ.,NCAA,32,11,10,21,14,6,85240
2014-15,Germany U20,WJC-20,6,2,2,4,2,-6,85240
2014-15,Tri-City Storm,USHL,54,12,28,40,84,-3,266919
2014-15,Cushing Academy,USHS-Prep,33,27,42,69,-,,225022
2014-15,Boston Jr. Bruins Selects U18,MHSL U18,13,15,9,24,4,,225022
2014-15,Team Royal,USA-S17,5,0,1,1,-,,225022
2014-15,Boston Advantage  U18,T1EHL U18,28,8,17,25,34,,203358
2014-15,USNTDP Juniors,USHL,20,3,1,4,68,5,206621
2014-15,U.S. National U18 Team,USDP,54,5,6,11,96,,206621
2014-15,USA U18,WJC-18,7,1,1,2,6,7,206621
2014-15,Lawrenceville School,USHS-Prep,26,3,7,10,-,,291003
2014-15,Beijing Ice Hockey,China,-,-,-,-,-,,291003
2014-15,China U18,WJC-18 D2B,5,0,2,2,16,-1,291003
2014-15,Regina Pats,WHL,64,11,30,41,95,45,85035
2014-15,HC Trinec U18,Czech U18,0,0,0,0,0,,213164
2014-15,HC Trinec U20,Czech U20,24,10,17,27,6,0,213164
2014-15,HC Trinec,Czech,27,0,2,2,4,-3,213164
2014-15,Czech Republic U18,WJC-18,5,0,0,0,0,0,213164
2014-15,Czech Republic U18 (all),International-Jr,20,10,7,17,2,-1,213164
2014-15,Czech Republic U20 (all),International-Jr,2,0,0,0,0,0,213164
2014-15,HC Trinec,Champions HL,4,0,1,1,0,1,213164
2014-15,Czech Republic U18,Hlinka Memorial,5,4,3,7,0,0,213164
2014-15,Harvard Univ.,NCAA,37,12,15,27,16,12,118545
2014-15,Plymouth Whalers,OHL,21,2,3,5,22,-4,234450
2014-15,Owen Sound Attack,OHL,32,0,4,4,36,-2,234450
2014-15,Rimouski Océanic,QMJHL,68,10,28,38,69,27,213536
2014-15,Rimouski Océanic,M-Cup,4,0,1,1,6,-4,213536
2014-15,USNTDP Juniors,USHL,25,0,7,7,16,16,245150
2014-15,U.S. National U18 Team,USDP,66,1,14,15,42,,245150
2014-15,USA U18,WJC-18,7,0,0,0,2,4,245150
2014-15,Team Royal,USA-S17,4,0,0,0,-,,245150
2014-15,Baie-Comeau Drakkar,QMJHL,36,10,9,19,89,4,151711
2014-15,Saint John Sea Dogs,QMJHL,23,3,6,9,48,-2,151711
2014-15,HPK U20,Jr. A SM-liiga,6,0,4,4,2,4,90023
2014-15,HPK,Liiga,32,5,5,10,8,-5,90023
2014-15,Finland U20 (all),International-Jr,7,0,2,2,10,6,90023
2014-15,Minnesota Wilderness,NAHL,55,12,31,43,63,38,135399
2014-15,Sarnia Sting,OHL,55,24,29,53,18,4,183258
2014-15,Peterborough Petes,OHL,59,16,21,37,15,-1,204707
2014-15,Victoria Royals,WHL,72,5,16,21,53,12,199398
2014-15,Team White,U18-Dev,3,0,0,0,2,,199398
2014-15,Kärpät U20,Jr. A SM-liiga,7,2,6,8,0,5,47273
2014-15,Kärpät,Liiga,35,0,2,2,4,7,47273
2014-15,Hokki,Mestis,2,0,2,2,2,3,47273
2014-15,Kärpät,Champions HL,6,0,1,1,0,2,47273
2014-15,Langley Rivermen,BCHL,50,20,26,46,57,,199950
2014-15,Canada West U19,WJAC-19,4,0,2,2,2,,199950
2014-15,Rögle BK J18,J18 Elit,11,10,4,14,8,4,212720
2014-15,Rögle BK J18,J18 Allsvenskan,7,4,7,11,0,1,212720
2014-15,Rögle BK J20,SuperElit,41,6,6,12,10,6,212720
2014-15,Sweden U18,WJC-18,5,1,0,1,0,-2,212720
2014-15,Sweden U18 (all),International-Jr,11,2,0,2,2,-1,212720
2014-15,Kimball Union Academy,USHS-Prep,33,19,20,39,-,,277759
2014-15,Boston Jr. Bruins U18,USPHL 18U,11,5,7,12,20,,277759
2014-15,Michigan Tech,NCAA,36,0,9,9,22,21,191271
2014-15,Mahtomedi High,USHS-MN,23,22,25,47,16,,248382
2014-15,Team Northeast,USHS-MN,17,9,4,13,10,,248382
2014-15,Sioux Falls Stampede,USHL,2,0,1,1,0,-1,248382
2014-15,Mahtomedi High,MN State,3,5,1,6,4,,248382
2014-15,North Bay Battalion,OHL,52,0,3,3,32,-2,245105
2014-15,Des Moines Buccaneers,USHL,42,6,10,16,80,1,248436
2014-15,JYP-Akatemia,Mestis,39,3,22,25,24,8,92502
2014-15,JYP,Liiga,12,0,1,1,6,1,92502
2014-15,Finland U20,WJC-20,5,0,0,0,0,2,92502
2014-15,Finland U20 (all),International-Jr,24,3,5,8,6,7,92502
2014-15,JYP,Champions HL,1,0,0,0,0,1,92502
2014-15,Saint John Sea Dogs,QMJHL,60,24,20,44,57,0,234343
2014-15,Sault Ste. Marie Greyhounds,OHL,67,5,39,44,14,33,142252
2014-15,Linköping HC J20,SuperElit,38,15,19,34,32,25,111641
2014-15,Linköping HC,SHL,15,0,1,1,2,0,111641
2014-15,Sweden U19 (all),International-Jr,4,0,1,1,2,1,111641
2014-15,Linköping HC,Champions HL,4,0,0,0,0,0,111641
2014-15,Prince Albert Raiders,WHL,72,16,15,31,44,-9,131328
2014-15,Team White,U18-Dev,3,0,0,0,0,,131328
2014-15,Team Southeast,USHS-MN,21,3,6,9,48,,300900
2014-15,Lakeville North High,USHS-MN,25,5,20,25,36,,300900
2014-15,Lakeville North High,MN State,3,1,1,2,2,,300900
2014-15,Ottawa 67's,OHL,63,19,28,47,49,3,169051
2014-15,Ak Bars Kazan,KHL,33,1,1,2,2,3,163859
2014-15,Bars Kazan,VHL,3,0,1,1,4,1,163859
2014-15,Russia U20,WJC-20,7,1,2,3,20,7,163859
2014-15,Russia U20 (all),International-Jr,16,1,2,3,22,,163859
2014-15,Russian Selects,Jr Super Series,5,0,0,0,0,0,163859
2014-15,Prince George Cougars,WHL,68,5,19,24,69,-13,199682
2014-15,Frölunda HC J18,J18 Elit,5,3,2,5,0,5,212530
2014-15,Frölunda HC J18,J18 Allsvenskan,9,11,3,14,6,12,212530
2014-15,Frölunda HC J20,SuperElit,28,20,15,35,2,11,212530
2014-15,Frölunda HC,SHL,2,0,0,0,0,0,212530
2014-15,Sweden U18,WJC-18,5,0,1,1,0,1,212530
2014-15,Sweden U18 (all),International-Jr,16,1,3,4,0,1,212530
2014-15,Sweden U18,Hlinka Memorial,5,0,2,2,0,0,212530
2015-16,ZSC Lions,NLA,36,24,22,46,6,16,199898
2015-16,USA U20,WJC-20,7,7,4,11,2,6,199898
2015-16,USA,WC,10,6,3,9,2,0,199898
2015-16,ZSC Lions,Champions HL,2,0,1,1,0,-1,199898
2015-16,ZSC Lions,Swiss Cup,4,4,3,7,0,,199898
2015-16,Tappara,Liiga,46,17,16,33,6,6,221667
2015-16,Finland U20,WJC-20,7,7,6,13,6,8,221667
2015-16,Finland U20 (all),International-Jr,15,13,8,21,10,10,221667
2015-16,Finland,EHT,2,0,0,0,2,-1,221667
2015-16,Finland,WC,10,7,5,12,4,4,221667
2015-16,Finland (all),International,12,7,5,12,6,3,221667
2015-16,Tappara,Champions HL,8,2,2,4,4,2,221667
2015-16,Cape Breton Screaming Eagles,QMJHL,62,42,57,99,112,40,252480
2015-16,Team White,U18-Dev,3,2,0,2,2,,252480
2015-16,Canada U18,Hlinka Memorial,4,0,3,3,0,1,252480
2015-16,QMJHL All-Stars,Jr Super Series,2,0,0,0,2,0,252480
2015-16,Kärpät,Liiga,50,13,15,28,22,5,152117
2015-16,Finland U18,WJC-18,4,5,2,7,2,2,152117
2015-16,Finland U20,WJC-20,7,5,12,17,0,8,152117
2015-16,Finland U20 (all),International-Jr,16,9,15,24,10,6,152117
2015-16,Kärpät,Champions HL,13,0,2,2,6,6,152117
2015-16,London Knights,OHL,57,9,33,42,16,38,196391
2015-16,Finland U20,WJC-20,7,0,9,9,4,6,196391
2015-16,Finland U20 (all),International-Jr,9,0,9,9,8,2,196391
2015-16,London Knights,M-Cup,4,0,7,7,4,6,196391
2015-16,London Knights,OHL,57,30,77,107,80,45,233030
2015-16,USA U20,WJC-20,7,4,7,11,6,7,233030
2015-16,London Knights,M-Cup,4,5,3,8,4,8,233030
2015-16,USNTDP Juniors,USHL,23,13,24,37,14,16,226432
2015-16,U.S. National U18 Team,USDP,62,37,70,107,40,,226432
2015-16,USA U18,WJC-18,7,4,10,14,2,11,226432
2015-16,Mississauga Steelheads,OHL,57,28,47,75,18,8,212641
2015-16,Sweden U18,WJC-18,7,3,8,11,0,5,212641
2015-16,Sweden U18 (all),International-Jr,12,5,12,17,6,7,212641
2015-16,Sweden U20,WJC-20,7,4,5,9,0,5,212641
2015-16,Sweden U20 (all),International-Jr,10,6,7,13,2,7,212641
2015-16,Sweden U18,Hlinka Memorial,5,2,4,6,6,2,212641
2015-16,Windsor Spitfires,OHL,67,17,40,57,56,15,312213
2015-16,Russia U18,WJC-18,5,0,0,0,8,0,312213
2015-16,Penticton Vees,BCHL,48,42,62,104,43,0,148111
2015-16,Canada U18,WJC-18,7,6,9,15,2,7,148111
2015-16,Team White,U18-Dev,3,1,1,2,2,,148111
2015-16,Canada U18,Hlinka Memorial,4,3,0,3,0,1,148111
2015-16,Canada West U19,WJAC-19,4,3,6,9,2,,148111
2015-16,Windsor Spitfires,OHL,59,21,53,74,40,24,248391
2015-16,U.S. National U18 Team,USDP,9,4,9,13,6,,248391
2015-16,USA U18,WJC-18,7,3,9,12,2,6,248391
2015-16,Team Red,U18-Dev,3,0,0,0,2,,248391
2015-16,Mississauga Steelheads,OHL,57,21,40,61,71,10,240821
2015-16,Canada U18,WJC-18,7,2,2,4,2,3,240821
2015-16,Team White,U18-Dev,3,1,5,6,8,3,240821
2015-16,Canada U18,Hlinka Memorial,4,1,1,2,2,4,240821
2015-16,OHL All-Stars,Jr Super Series,1,0,0,0,0,0,240821
2015-16,Calgary Hitmen,WHL,68,24,40,64,28,8,199660
2015-16,Team White,U18-Dev,3,1,2,3,2,,199660
2015-16,Canada U18,Hlinka Memorial,4,0,1,1,4,2,199660
2015-16,WHL All-Stars,Jr Super Series,2,0,1,1,0,0,199660
2015-16,Boston Univ.,NCAA,37,3,22,25,56,10,245142
2015-16,USA U20,WJC-20,7,0,0,0,0,5,245142
2015-16,Univ. of Wisconsin,NCAA,34,19,13,32,34,-9,245278
2015-16,Sarnia Sting,OHL,62,11,38,49,51,23,243386
2015-16,Canada U18,WJC-18,7,1,3,4,8,5,243386
2015-16,OHL All-Stars,Jr Super Series,1,0,0,0,0,0,243386
2015-16,Penticton Vees,BCHL,45,14,53,67,30,0,247041
2015-16,Canada U18,WJC-18,7,0,8,8,16,5,247041
2015-16,Team Red,U18-Dev,3,1,1,2,0,,247041
2015-16,Canada U18,Hlinka Memorial,4,0,0,0,0,2,247041
2015-16,Canada West U19,WJAC-19,4,0,3,3,4,,247041
2015-16,Windsor Spitfires,OHL,64,5,12,17,103,7,240108
2015-16,Canada U18,WJC-18,7,0,1,1,12,-1,240108
2015-16,USNTDP Juniors,USHL,23,16,16,32,41,17,247945
2015-16,U.S. National U18 Team,USDP,62,50,31,81,101,,247945
2015-16,USA U18,WJC-18,7,5,3,8,8,6,247945
2015-16,Chilliwack Chiefs,BCHL,50,12,28,40,16,2,247137
2015-16,Canada West U19,WJAC-19,4,0,2,2,0,,247137
2015-16,Val-d'Or Foreurs,QMJHL,54,41,16,57,24,24,213464
2015-16,Canada U20,WJC-20,5,0,2,2,0,0,213464
2015-16,QMJHL All-Stars,Jr Super Series,2,0,1,1,0,2,213464
2015-16,Team Russia U18,MHL,28,12,14,26,10,12,312227
2015-16,Russia U18,Hlinka Memorial,5,1,3,4,16,-1,312227
2015-16,Russia U19,WJAC-19,4,2,4,6,0,,312227
2015-16,HIFK U20,Jr. A SM-liiga,40,29,26,55,20,23,118332
2015-16,Finland U19 (all),International-Jr,3,1,2,3,0,1,118332
2015-16,London Knights,OHL,63,28,24,52,106,30,233448
2015-16,London Knights,M-Cup,4,2,2,4,8,3,233448
2015-16,Blaine High,USHS-MN,25,47,31,78,53,,291903
2015-16,Fargo Force,USHL,27,10,4,14,30,-5,291903
2015-16,Team Red,USA-S17,5,0,7,7,4,,291903
2015-16,USA U18,Hlinka Memorial,4,0,0,0,2,-1,291903
2015-16,Univ. of Connecticut,NCAA,36,14,18,32,12,-14,301349
2015-16,Moose Jaw Warriors,WHL,68,24,40,64,61,-7,232712
2015-16,Canada U18,WJC-18,6,5,3,8,8,2,232712
2015-16,Team Red,U18-Dev,3,1,2,3,2,,232712
2015-16,Canada U18,Hlinka Memorial,4,0,1,1,4,0,232712
2015-16,Kelowna Rockets,WHL,69,10,39,49,20,11,199937
2015-16,USNTDP Juniors,USHL,23,4,10,14,23,5,272221
2015-16,U.S. National U18 Team,USDP,61,20,20,40,73,,272221
2015-16,USA U18,WJC-18,7,4,3,7,4,6,272221
2015-16,Regina Pats,WHL,72,23,47,70,24,-8,154496
2015-16,Team White,U18-Dev,3,1,0,1,2,,154496
2015-16,Canada U18,Hlinka Memorial,4,1,2,3,2,1,154496
2015-16,Lokomotiv Yaroslavl,KHL,41,6,6,12,23,1,176637
2015-16,Loko Yaroslavl,MHL,4,2,4,6,6,3,176637
2015-16,Russia U20,WJC-20,7,2,6,8,16,4,176637
2015-16,Russia (all),International,1,0,0,0,0,0,176637
2015-16,Vancouver Giants,WHL,30,9,19,28,46,0,154220
2015-16,Team White,U18-Dev,3,0,1,1,0,,154220
2015-16,Canada U18,Hlinka Memorial,4,1,4,5,0,4,154220
2015-16,Färjestad BK,SHL,46,4,8,12,16,10,139616
2015-16,Sweden U20,WJC-20,7,3,2,5,6,3,139616
2015-16,Sweden U20 (all),International-Jr,16,5,4,9,6,6,139616
2015-16,Färjestad BK,Champions HL,6,0,1,1,4,0,139616
2015-16,Green Bay Gamblers,USHL,56,4,26,30,30,7,291905
2015-16,Team Forest,USA-S17,5,1,3,4,0,,291905
2015-16,USA U18,Hlinka Memorial,4,0,1,1,4,0,291905
2015-16,USA U19,WJAC-19,5,1,1,2,2,,291905
2015-16,Sarnia Sting,OHL,65,17,34,51,14,13,269034
2015-16,Canada U18,WJC-18,7,5,3,8,0,5,269034
2015-16,Team Red,U18-Dev,3,1,0,1,0,,269034
2015-16,Canada U18,Hlinka Memorial,4,1,1,2,4,-1,269034
2015-16,OHL All-Stars,Jr Super Series,1,1,0,1,0,1,269034
2015-16,Victoriaville Tigres,QMJHL,56,23,45,68,64,-3,252492
2015-16,Canada U18,WJC-18,7,2,2,4,4,-2,252492
2015-16,Team White,U18-Dev,3,0,1,1,0,,252492
2015-16,Saskatoon Blades,WHL,69,3,23,26,76,-19,195023
2015-16,Czech Republic U18,WJC-18,5,0,2,2,6,-2,195023
2015-16,Czech Republic U18 (all),International-Jr,10,0,3,3,12,-4,195023
2015-16,Czech Republic U18,Hlinka Memorial,4,0,1,1,4,-3,195023
2015-16,Kitchener Rangers,OHL,65,35,46,81,16,19,240112
2015-16,Team Red,U18-Dev,3,0,3,3,0,,240112
2015-16,Erie Otters,OHL,60,51,50,101,28,18,231275
2015-16,USA U20,WJC-20,5,1,0,1,25,1,231275
2015-16,Youngstown Phantoms,USHL,60,34,32,66,42,38,268696
2015-16,Canada U18,WJC-18,7,1,3,4,0,5,268696
2015-16,Team Red,U18-Dev,3,1,1,2,2,,268696
2015-16,Mississauga Steelheads,OHL,64,19,40,59,50,-3,245157
2015-16,OHL All-Stars,Jr Super Series,1,0,0,0,0,0,245157
2015-16,Timrå IK J20,SuperElit,3,2,1,3,0,-2,212368
2015-16,Timrå IK,Allsvenskan,51,15,14,29,8,0,212368
2015-16,Sweden U19 (all),International-Jr,4,1,2,3,2,3,212368
2015-16,Kärpät U18,Jr. B SM-sarja,0,0,0,0,0,,209426
2015-16,Kärpät U20,Jr. A SM-liiga,47,22,31,53,53,18,209426
2015-16,Kärpät,Liiga,1,2,0,2,0,1,209426
2015-16,Hokki,Mestis,1,1,1,2,2,2,209426
2015-16,Finland U18,WJC-18,7,3,4,7,4,2,209426
2015-16,Finland U18,Hlinka Memorial,5,0,6,6,4,4,209426
2015-16,Sault Ste. Marie Greyhounds,OHL,63,24,27,51,61,7,269859
2015-16,Canada U18,WJC-18,5,1,1,2,8,0,269859
2015-16,USNTDP Juniors,USHL,18,2,11,13,19,-2,229559
2015-16,U.S. National U18 Team,USDP,53,3,26,29,78,,229559
2015-16,USA U18,WJC-18,7,0,3,3,33,4,229559
2015-16,USA U20,WJC-20,7,0,0,0,2,-1,229559
2015-16,Guelph Storm,OHL,65,23,19,42,146,-27,252472
2015-16,Shawinigan Cataractes,QMJHL,67,10,64,74,10,24,251476
2015-16,Team Red,U18-Dev,3,0,2,2,0,,251476
2015-16,Canada U18,Hlinka Memorial,4,1,0,1,0,4,251476
2015-16,QMJHL All-Stars,Jr Super Series,2,0,3,3,0,0,251476
2015-16,USNTDP Juniors,USHL,25,4,8,12,16,4,226442
2015-16,U.S. National U18 Team,USDP,61,6,19,25,60,,226442
2015-16,USA U18,WJC-18,7,2,3,5,4,5,226442
2015-16,Team Russia U18,MHL,39,12,19,31,12,28,312217
2015-16,Russia U18,Hlinka Memorial,5,2,4,6,0,2,312217
2015-16,Russia U19,WJAC-19,4,1,5,6,0,,312217
2015-16,Brandon Wheat Kings,WHL,71,6,37,43,54,25,108472
2015-16,Team White,U18-Dev,3,0,2,2,0,,108472
2015-16,Brandon Wheat Kings,M-Cup,3,0,0,0,2,-4,108472
2015-16,Canada U18,Hlinka Memorial,4,1,0,1,2,2,108472
2015-16,WHL All-Stars,Jr Super Series,2,1,0,1,0,-1,108472
2015-16,Tri-City Storm,USHL,56,25,22,47,46,16,199949
2015-16,HC Hradec Kralove U20,Czech U20,13,4,12,16,12,-2,191286
2015-16,HK Hradec Kralove,Czech,40,0,4,4,22,3,191286
2015-16,HC Litomerice,Czech2,12,2,2,4,18,0,191286
2015-16,Czech Republic U19 (all),International-Jr,8,3,0,3,6,-2,191286
2015-16,Czech Republic U20,WJC-20,5,0,2,2,4,3,191286
2015-16,Czech Republic U20 (all),International-Jr,13,2,4,6,10,,191286
2015-16,Kelowna Rockets,WHL,65,26,40,66,50,8,157256
2015-16,Team White,U18-Dev,3,1,0,1,2,,157256
2015-16,Canada U18,Hlinka Memorial,4,1,2,3,2,2,157256
2015-16,MODO Hockey J20,SuperElit,1,0,0,0,0,-1,113516
2015-16,MODO Hockey,SHL,49,7,9,16,53,-2,113516
2015-16,Sweden U20,WJC-20,7,1,0,1,6,1,113516
2015-16,Sweden U20 (all),International-Jr,20,4,4,8,16,2,113516
2015-16,Erie Otters,OHL,67,24,49,73,18,19,245610
2015-16,OHL All-Stars,Jr Super Series,1,0,0,0,2,0,245610
2015-16,Univ. of Denver,NCAA,41,17,30,47,19,14,192301
2015-16,Blues U20,Jr. A SM-liiga,45,28,38,66,32,5,122146
2015-16,Finland U20,WJC-20,7,1,1,2,2,2,122146
2015-16,Finland U20 (all),International-Jr,15,3,1,4,4,6,122146
2015-16,Saginaw Spirit,OHL,65,1,26,27,28,-23,175894
2015-16,Finland U18,WJC-18,7,0,1,1,6,1,175894
2015-16,Finland U18,Hlinka Memorial,5,0,2,2,6,3,175894
2015-16,USNTDP Juniors,USHL,20,3,3,6,27,-2,272186
2015-16,U.S. National U18 Team,USDP,59,13,20,33,35,,272186
2015-16,USA U18,WJC-18,7,1,6,7,0,8,272186
2015-16,Gatineau Olympiques,QMJHL,63,38,55,93,36,36,295715
2015-16,USNTDP Juniors,USHL,25,5,17,22,2,12,248380
2015-16,U.S. National U18 Team,USDP,64,9,50,59,12,,248380
2015-16,USA U18,WJC-18,7,1,8,9,0,15,248380
2015-16,Cedar Rapids RoughRiders,USHL,56,19,17,36,99,5,286690
2015-16,North Bay Battalion,OHL,68,13,46,59,18,18,268444
2015-16,Team White,USA-S17,5,1,1,2,0,,268444
2015-16,USA U18,Hlinka Memorial,4,0,2,2,2,3,268444
2015-16,London Knights,OHL,63,12,19,31,24,12,245616
2015-16,London Knights,M-Cup,4,1,2,3,0,1,245616
2015-16,Flint Firebirds,OHL,67,30,35,65,32,-29,245965
2015-16,Canada U18,WJC-18,7,3,5,8,2,5,245965
2015-16,Team White,U18-Dev,3,2,1,3,0,,245965
2015-16,Canada U18,Hlinka Memorial,4,1,1,2,0,2,245965
2015-16,OHL All-Stars,Jr Super Series,1,0,0,0,0,0,245965
2015-16,Prince George Cougars,WHL,39,1,5,6,86,-4,247061
2015-16,Team White,U18-Dev,3,0,0,0,0,,247061
2015-16,USNTDP Juniors,USHL,25,2,8,10,8,12,226438
2015-16,U.S. National U18 Team,USDP,64,5,23,28,62,,226438
2015-16,USA U18,WJC-18,7,1,6,7,4,16,226438
2015-16,USNTDP Juniors,USHL,25,10,10,20,14,14,247964
2015-16,U.S. National U18 Team,USDP,64,27,30,57,20,,247964
2015-16,USA U18,WJC-18,7,7,2,9,2,12,247964
2015-16,Spokane Chiefs,WHL,56,19,25,44,46,9,107909
2015-16,Muskegon Lumberjacks,USHL,56,46,43,89,74,6,199968
2015-16,USA U19,WJAC-19,5,2,2,4,2,,199968
2015-16,Elmira Sugar Kings,GOJHL,3,1,0,1,6,,254039
2015-16,Kitchener Rangers,OHL,39,2,7,9,49,7,254039
2015-16,Canada U18,WJC-18,6,1,1,2,4,2,254039
2015-16,Chicoutimi Saguenéens,QMJHL,64,14,45,59,34,-7,213473
2015-16,Saint John Sea Dogs,QMJHL,61,10,25,35,29,18,195389
2015-16,Team White,U18-Dev,3,0,0,0,4,,195389
2015-16,Shawinigan Cataractes,QMJHL,67,24,37,61,41,9,213725
2015-16,Mississauga Steelheads,OHL,57,6,16,22,27,-13,228106
2015-16,Team Red,U18-Dev,3,0,0,0,2,,228106
2015-16,Calgary Hitmen,WHL,67,20,25,45,42,21,107898
2015-16,Georgetown Raiders,OJHL,46,9,24,33,42,,245621
2015-16,Canada East U19,WJAC-19,5,0,0,0,4,,245621
2015-16,Red Deer Rebels,WHL,2,0,1,1,0,1,166669
2015-16,Team White,U18-Dev,3,0,0,0,0,,166669
2015-16,Red Deer Rebels,M-Cup,4,0,0,0,2,-1,166669
2015-16,Canada U18,Hlinka Memorial,4,1,0,1,2,2,166669
2015-16,Boston College,NCAA,39,4,23,27,46,27,177660
2015-16,Kamloops Blazers,WHL,71,15,32,47,24,1,49041
2015-16,Luleå HF J18,J18 Elit,3,2,6,8,4,13,240064
2015-16,Luleå HF J20,SuperElit,42,5,16,21,22,-5,240064
2015-16,Luleå HF,SHL,10,0,0,0,0,0,240064
2015-16,Sweden U18 (all),International-Jr,8,0,3,3,0,3,240064
2015-16,Sweden U18,Hlinka Memorial,4,0,0,0,0,-1,240064
2015-16,AIK J18,J18 Elit,8,7,12,19,6,3,220059
2015-16,AIK J18,J18 Allsvenskan,1,4,0,4,0,2,220059
2015-16,AIK J20,SuperElit,44,13,20,33,16,4,220059
2015-16,AIK,Allsvenskan,2,0,0,0,2,-1,220059
2015-16,Skellefteå AIK J20,SuperElit,43,19,22,41,6,8,113834
2015-16,Skellefteå AIK,SHL,5,0,0,0,0,1,113834
2015-16,Sweden U19 (all),International-Jr,4,0,3,3,0,1,113834
2015-16,Regina Pats,WHL,72,38,82,120,30,41,120202
2015-16,Sault Ste. Marie Greyhounds,OHL,67,20,23,43,12,-5,233512
2015-16,Team Orange,USA-S17,5,3,1,4,0,,233512
2015-16,Peterborough Petes,OHL,68,21,28,49,44,-5,251447
2015-16,Team Red,U18-Dev,3,0,0,0,0,,251447
2015-16,Avtomobilist Yekaterinburg,KHL,56,25,19,44,26,5,205469
2015-16,Russia,EHT,2,0,0,0,0,0,205469
2015-16,Russia (all),International,2,0,0,0,0,0,205469
2015-16,Avtomobilist Yekaterinburg,Spengler Cup,4,1,2,3,2,-1,205469
2015-16,Skellefteå AIK J18,J18 Elit,2,1,4,5,0,1,242668
2015-16,Skellefteå AIK J18,J18 Allsvenskan,0,0,0,0,0,0,242668
2015-16,Skellefteå AIK J20,SuperElit,40,14,30,44,28,9,242668
2015-16,Skellefteå AIK,SHL,4,1,0,1,0,1,242668
2015-16,Sweden U18,WJC-18,7,1,3,4,6,4,242668
2015-16,Sweden U18 (all),International-Jr,20,5,5,10,12,7,242668
2015-16,Sweden U18,Hlinka Memorial,5,0,1,1,4,1,242668
2015-16,HV71 J18,J18 Elit,2,0,5,5,0,-2,169012
2015-16,HV71 J18,J18 Allsvenskan,5,1,1,2,6,2,169012
2015-16,HV71 J20,SuperElit,35,1,4,5,28,3,169012
2015-16,HV71,SHL,9,0,0,0,0,-5,169012
2015-16,Sweden U18,WJC-18,7,0,0,0,6,-2,169012
2015-16,Sweden U18 (all),International-Jr,21,1,4,5,26,-1,169012
2015-16,HV71,Champions HL,5,0,0,0,0,2,169012
2015-16,Sweden U18,Hlinka Memorial,5,1,0,1,12,-2,169012
2015-16,TPS U18,Jr. B SM-sarja,0,0,0,0,0,,221513
2015-16,TPS U20,Jr. A SM-liiga,11,2,4,6,14,4,221513
2015-16,Finland U18,Hlinka Memorial,5,0,1,1,6,1,221513
2015-16,TPS U20,JCWC,3,0,0,0,14,1,221513
2015-16,Carleton Place Canadians,CCHL,48,14,32,46,16,,267772
2015-16,Canada East U19,WJAC-19,5,2,0,2,4,,267772
2015-16,Carleton Place Canadians,Fred Page Cup,4,1,3,4,0,,267772
2015-16,Carleton Place Canadians,RBC Cup,4,1,1,2,2,,267772
2015-16,London Knights,OHL,68,8,30,38,18,53,232703
2015-16,Team Red,U18-Dev,3,0,0,0,2,,232703
2015-16,London Knights,M-Cup,4,1,0,1,2,5,232703
2015-16,Canada U18,Hlinka Memorial,4,0,1,1,0,1,232703
2015-16,OHL All-Stars,Jr Super Series,1,0,0,0,2,1,232703
2015-16,Saginaw Spirit,OHL,66,1,6,7,66,-24,249597
2015-16,Team White,U18-Dev,3,0,1,1,6,,249597
2015-16,Team Russia U18,MHL,29,11,12,23,20,13,312218
2015-16,Russia U19,WJAC-19,4,2,2,4,2,,312218
2015-16,Fairbanks Ice Dogs,NAHL,60,38,57,95,42,27,206321
2015-16,Chicago Steel,USHL,55,16,21,37,14,-2,248441
2015-16,Chicago Steel,JCWC,5,5,1,6,2,3,248441
2015-16,USA U19,WJAC-19,5,5,3,8,0,,248441
2015-16,Chicago Steel,USHL,39,10,22,32,97,5,202463
2015-16,Tri-City Storm,USHL,18,5,5,10,46,3,202463
2015-16,Chicago Steel,JCWC,5,5,0,5,8,3,202463
2015-16,Örebro HK J18,J18 Allsvenskan,6,3,1,4,10,2,212632
2015-16,Örebro HK J20,SuperElit,41,2,6,8,36,-14,212632
2015-16,Skellefteå AIK J18,J18 Elit,10,4,9,13,2,9,242658
2015-16,Skellefteå AIK J18,J18 Allsvenskan,16,2,14,16,6,10,242658
2015-16,Skellefteå AIK J20,SuperElit,2,1,0,1,2,-1,242658
2015-16,Kitchener Rangers,OHL,68,16,22,38,14,18,267790
2015-16,Brynäs IF J20,SuperElit,15,1,10,11,53,11,212334
2015-16,Brynäs IF,SHL,35,4,5,9,8,-4,212334
2015-16,Sweden U19 (all),International-Jr,4,3,2,5,0,8,212334
2015-16,Moose Jaw Warriors,WHL,72,28,45,73,33,-2,162892
2015-16,Canada U18,WJC-18,5,0,2,2,2,0,162892
2015-16,HV71 J18,J18 Elit,1,0,0,0,27,1,212726
2015-16,HV71 J18,J18 Allsvenskan,4,1,1,2,4,3,212726
2015-16,HV71 J20,SuperElit,41,5,16,21,22,3,212726
2015-16,HV71,SHL,4,0,0,0,0,0,212726
2015-16,Sweden U18,WJC-18,7,1,4,5,0,0,212726
2015-16,Sweden U18 (all),International-Jr,19,1,6,7,4,4,212726
2015-16,HV71,Champions HL,3,0,1,1,0,0,212726
2015-16,Sweden U18,Hlinka Memorial,3,0,0,0,0,1,212726
2015-16,Saint John Sea Dogs,QMJHL,61,21,36,57,94,4,183451
2015-16,QMJHL All-Stars,Jr Super Series,2,0,0,0,0,0,183451
2015-16,Oshawa Generals,OHL,62,6,15,21,69,-9,252469
2015-16,Gatineau Olympiques,QMJHL,54,25,48,73,10,31,213787
2015-16,Univ. of North Dakota,NCAA,41,11,7,18,52,10,119371
2015-16,Genève-Servette U20,Elite Jr. A,4,3,5,8,10,,153634
2015-16,Genève-Servette HC,NLA,45,9,12,21,34,-3,153634
2015-16,Switzerland U20,WJC-20,6,2,2,4,8,-3,153634
2015-16,Switzerland U20 (all),International-Jr,15,4,7,11,24,,153634
2015-16,Genève-Servette HC,Champions HL,4,0,1,1,6,0,153634
2015-16,Genève-Servette HC,Swiss Cup,2,2,2,4,0,,153634
2015-16,Cedar Rapids RoughRiders,USHL,55,35,31,66,79,32,300911
2015-16,USA U19,WJAC-19,5,4,1,5,0,,300911
2015-16,Brandon Wheat Kings,WHL,53,13,18,31,37,15,201245
2015-16,Team White,U18-Dev,3,1,1,2,2,,201245
2015-16,Brandon Wheat Kings,M-Cup,3,0,0,0,0,-2,201245
2015-16,Canada U18,Hlinka Memorial,4,0,0,0,0,2,201245
2015-16,Ilves U20,Jr. A SM-liiga,49,26,32,58,18,25,241338
2015-16,Ilves,Liiga,1,0,0,0,0,-2,241338
2015-16,Finland U18,Hlinka Memorial,5,1,0,1,6,-1,241338
2015-16,Lincoln Stars,USHL,60,3,27,30,112,8,266154
2015-16,Victoria Royals,WHL,72,28,39,67,60,45,268059
2015-16,Team Southwest,USHS-MN,17,2,10,12,8,,300828
2015-16,Hill-Murray School,USHS-MN,12,3,4,7,4,,300828
2015-16,Team Columbia,USA-S17,5,1,3,4,2,,300828
2015-16,Northeastern Univ.,NCAA,41,20,22,42,10,13,146116
2015-16,Grand Rapids High,USHS-MN,25,17,29,46,22,,291902
2015-16,Bloomington Thunder,USHL,21,2,0,2,8,-8,291902
2015-16,Team Orange,USA-S17,5,0,2,2,0,,291902
2015-16,Grand Rapids High,MN State,3,1,1,2,2,,291902
2015-16,Calgary Hitmen,WHL,68,21,28,49,20,0,199912
2015-16,Linköping HC J20,SuperElit,45,4,14,18,51,11,146985
2015-16,Prince Albert Raiders,WHL,70,3,13,16,20,0,201615
2015-16,Czech Republic U18,WJC-18,5,0,2,2,8,1,201615
2015-16,Czech Republic U18 (all),International-Jr,10,0,2,2,8,-4,201615
2015-16,Czech Republic U18,Hlinka Memorial,4,0,0,0,0,-4,201615
2015-16,SKA St. Petersburg,KHL,10,0,1,1,0,4,269022
2015-16,SKA-Neva St. Petersburg,VHL,10,0,2,2,8,0,269022
2015-16,SKA-1946 St. Petersburg,MHL,20,3,7,10,10,2,269022
2015-16,Russia U20,WJC-20,7,1,2,3,2,5,269022
2015-16,Russian Selects U20,Jr Super Series,6,0,1,1,0,-3,269022
2015-16,Swift Current Broncos,WHL,62,8,29,37,28,-21,161131
2015-16,Ilves U20,Jr. A SM-liiga,40,9,17,26,14,12,279893
2015-16,Finland U18,WJC-18,7,0,0,0,2,-1,279893
2015-16,Finland U18,Hlinka Memorial,5,1,0,1,0,3,279893
2015-16,Lone Star Brahmas,NAHL,59,9,41,50,29,3,288967
2015-16,Erie Otters,OHL,67,9,18,27,40,11,268675
2015-16,Avon Old Farms School,USHS-Prep,27,20,39,59,-,,229608
2015-16,Neponset Valley River Rats U18,MHSL U18,13,19,13,32,4,,229608
2015-16,Omaha Lancers,USHL,9,1,3,4,2,-8,229608
2015-16,Team Kelly,USA-S17,5,5,3,8,2,,229608
2015-16,USA U18,Hlinka Memorial,4,0,0,0,0,0,229608
2015-16,Växjö Lakers HC J18,J18 Elit,13,3,9,12,6,7,244643
2015-16,Växjö Lakers HC J20,SuperElit,39,7,18,25,14,-7,244643
2015-16,Växjö Lakers HC,SHL,2,0,0,0,0,-1,244643
2015-16,Hamilton Bulldogs,OHL,37,4,16,20,12,-12,247116
2015-16,Sault Ste. Marie Greyhounds,OHL,60,17,22,39,32,-4,272570
2015-16,Team Gold,USA-S17,5,3,2,5,0,,272570
2015-16,USA U18,Hlinka Memorial,4,2,2,4,30,2,272570
2015-16,St. Cloud State Univ.,NCAA,40,14,19,33,20,14,196603
2015-16,Rögle BK J20,SuperElit,36,6,15,21,42,-2,220307
2015-16,Rögle BK,SHL,16,2,2,4,0,0,220307
2015-16,Denmark U20,WJC-20,4,1,1,2,4,-2,220307
2015-16,Denmark U20 (all),International-Jr,12,2,1,3,8,,220307
2015-16,Denmark,WC,0,0,0,0,0,0,220307
2015-16,Denmark (all),International,8,2,3,5,0,,220307
2015-16,Red Deer Rebels,WHL,55,13,33,46,49,13,84020
2015-16,Red Deer Rebels,M-Cup,4,0,2,2,4,4,84020
2015-16,WHL All-Stars,Jr Super Series,2,1,0,1,0,1,84020
2015-16,Calgary Hitmen,WHL,70,8,17,25,47,0,247477
2015-16,Canada U18,WJC-18,7,1,2,3,4,2,247477
2015-16,Team Red,U18-Dev,3,0,1,1,0,,247477
2015-16,Canada U18,Hlinka Memorial,4,1,1,2,4,3,247477
2015-16,Flint Firebirds,OHL,64,20,17,37,40,-22,252448
2015-16,Djurgårdens IF J18,J18 Elit,4,2,1,3,2,-1,246070
2015-16,Djurgårdens IF J18,J18 Allsvenskan,2,0,0,0,2,0,246070
2015-16,Djurgårdens IF J20,SuperElit,39,13,16,29,8,11,246070
2015-16,Sweden U18,WJC-18,7,2,2,4,4,1,246070
2015-16,Sweden U18 (all),International-Jr,16,3,3,6,4,0,246070
2015-16,Djurgårdens IF J20,JCWC,5,0,0,0,6,-2,246070
2015-16,Niagara IceDogs,OHL,57,5,11,16,18,-6,252451
2015-16,USNTDP Juniors,USHL,20,5,0,5,16,1,226444
2015-16,U.S. National U18 Team,USDP,58,10,8,18,51,,226444
2015-16,USA U18,WJC-18,7,2,3,5,29,3,226444
2015-16,Moncton Wildcats,QMJHL,54,29,35,64,41,23,86675
2015-16,Germany U20,WJC-20 D1A,5,0,1,1,2,-3,86675
2015-16,Blues U18,Jr. B SM-sarja,5,2,3,5,0,,241335
2015-16,Blues U20,Jr. A SM-liiga,12,0,0,0,4,1,241335
2015-16,Jokerit U20,Jr. A SM-liiga,27,2,5,7,10,10,241335
2015-16,Victoria Royals,WHL,72,36,48,84,85,30,195217
2015-16,Tappara U18,Jr. B SM-sarja,0,0,0,0,0,,118081
2015-16,Tappara U20,Jr. A SM-liiga,50,19,19,38,26,17,118081
2015-16,Finland U18,WJC-18,7,3,6,9,12,8,118081
2015-16,Finland U18,Hlinka Memorial,5,0,3,3,2,-2,118081
2015-16,Vancouver Giants,WHL,12,2,2,4,4,-6,197807
2015-16,Calgary Hitmen,WHL,57,34,22,56,8,8,197807
2015-16,HPK U20,Jr. A SM-liiga,29,9,5,14,22,-3,123542
2015-16,HPK,Liiga,10,0,1,1,0,-6,123542
2015-16,Finland U18,WJC-18,7,2,2,4,0,1,123542
2015-16,Finland U18,Hlinka Memorial,5,2,2,4,2,1,123542
2015-16,Oakville Blades,OJHL,50,13,53,66,86,,219542
2015-16,Whitecourt Wolverines,AJHL,3,1,2,3,2,,161843
2015-16,Red Deer Rebels,WHL,72,13,34,47,46,22,161843
2015-16,Red Deer Rebels,M-Cup,4,0,1,1,2,1,161843
2015-16,Sudbury Wolves,OHL,64,10,18,28,98,-44,269038
2015-16,Culver Military Academy Prep,USHS-Prep,48,9,34,43,49,43,353810
2015-16,Team Royal,USA-S17,5,0,2,2,0,,353810
2015-16,AIK J20,SuperElit,2,1,1,2,2,1,117698
2015-16,AIK,Allsvenskan,48,8,9,17,6,1,117698
2015-16,Sweden U18,WJC-18,7,2,2,4,2,-2,117698
2015-16,Sweden U18 (all),International-Jr,21,8,8,16,6,1,117698
2015-16,Sweden U18,Hlinka Memorial,5,3,2,5,0,0,117698
2015-16,TPS U18,Jr. B SM-sarja,0,0,0,0,0,,158967
2015-16,TPS U20,Jr. A SM-liiga,49,19,17,36,34,6,158967
2015-16,TPS,Liiga,2,0,0,0,0,-2,158967
2015-16,Finland U18,WJC-18,7,0,2,2,0,2,158967
2015-16,TPS U20,JCWC,4,1,2,3,2,-1,158967
2015-16,Guelph Storm,OHL,67,3,11,14,46,-48,240028
2015-16,Färjestad BK J20,SuperElit,33,8,24,32,37,12,212666
2015-16,Färjestad BK,SHL,17,0,6,6,4,8,212666
2015-16,Sweden U18,WJC-18,7,2,1,3,6,-1,212666
2015-16,Sweden U18 (all),International-Jr,21,6,5,11,18,2,212666
2015-16,Sweden U18,Hlinka Memorial,5,0,0,0,4,-3,212666
2015-16,Victoria Royals,WHL,72,37,39,76,16,11,161060
2015-16,Chicago Steel,USHL,33,13,27,40,20,9,234312
2015-16,Lincoln Stars,USHL,19,11,12,23,18,1,234312
2015-16,Chicago Steel,JCWC,5,1,7,8,6,1,234312
2015-16,USA U19,WJAC-19,5,0,3,3,2,,234312
2015-16,Muskegon Lumberjacks,USHL,59,27,34,61,37,2,233489
2015-16,Team Grey,USA-S17,5,6,2,8,0,,233489
2015-16,Rouyn-Noranda Huskies,QMJHL,63,20,25,45,43,29,213781
2015-16,Rouyn-Noranda Huskies,M-Cup,5,1,1,2,8,-1,213781
2015-16,Sarnia Sting,OHL,62,17,13,30,29,-5,254246
2015-16,Univ. of Denver,NCAA,39,3,8,11,14,9,248356
2015-16,CSKA Moskva,KHL,48,4,3,7,57,2,155384
2015-16,Zvezda Chekhov,VHL,5,0,1,1,2,2,155384
2015-16,Russia (all),International,1,1,0,1,0,0,155384
2015-16,MODO Hockey J18,J18 Elit,4,4,6,10,2,11,212688
2015-16,MODO Hockey J18,J18 Allsvenskan,13,6,13,19,12,19,212688
2015-16,MODO Hockey J20,SuperElit,36,3,4,7,14,1,212688
2015-16,Quinnipiac Univ.,NCAA,43,4,22,26,2,16,177666
2015-16,Loko Yaroslavl,MHL,3,0,0,0,0,0,324561
2015-16,Loko-Yunior Yaroslavl,MHL B,39,4,8,12,66,9,324561
2015-16,London Knights,OHL,39,4,6,10,24,4,251744
2015-16,North Bay Battalion,OHL,67,4,9,13,16,14,245255
2015-16,Univ. of Connecticut,NCAA,34,6,15,21,40,-18,222493
2015-16,HK MVD Balashikha,MHL,39,13,22,35,59,14,300931
2015-16,Providence College,NCAA,19,1,1,2,8,1,264690
2015-16,Portland Winterhawks,WHL,62,20,29,49,42,9,154962
2015-16,Latvia U20,WJC-20 D1A,5,4,1,5,0,1,154962
2015-16,Latvia U20 (all),International-Jr,7,7,1,8,2,,154962
2015-16,Latvia,WC,7,0,1,1,0,-2,154962
2015-16,Latvia (all),International,14,5,2,7,31,1,154962
2015-16,Kelowna Rockets,WHL,61,18,27,45,54,19,186336
2015-16,Switzerland U20,WJC-20,5,1,1,2,2,-2,186336
2015-16,Switzerland U20 (all),International-Jr,14,2,2,4,31,,186336
2015-16,Ottawa 67's,OHL,58,9,23,32,35,17,248808
2015-16,Belarus U20,WJC-20,6,1,1,2,0,-6,248808
2015-16,AIK J18,J18 Elit,21,4,16,20,24,21,246448
2015-16,AIK J18,J18 Allsvenskan,15,2,8,10,45,6,246448
2015-16,AIK J20,SuperElit,6,0,0,0,6,-6,246448
2015-16,AIK,Allsvenskan,1,0,0,0,0,-2,246448
2015-16,Portage Terriers,MJHL,42,8,14,22,28,,247935
2015-16,Canada West U19,WJAC-19,4,0,0,0,0,,247935
2015-16,Mississauga Steelheads,OHL,65,2,8,10,53,19,267695
2015-16,Team Grey,USA-S17,5,0,2,2,6,,267695
2015-16,Serebryanye Lvy St. Petersburg,MHL,42,23,32,55,34,10,313721
2015-16,Ottawa 67's,OHL,60,13,24,37,26,7,252446
2015-16,Team Red,U18-Dev,3,0,1,1,2,,252446
2015-16,Bloomington Thunder,USHL,60,13,36,49,48,-8,213454
2015-16,USNTDP Juniors,USHL,21,3,5,8,22,4,233429
2015-16,U.S. National U18 Team,USDP,60,13,8,21,68,,233429
2015-16,USA U18,WJC-18,7,3,1,4,8,5,233429
2015-16,North Bay Battalion,OHL,66,26,27,53,43,1,207349
2015-16,Kimball Union Academy,USHS-Prep,35,24,46,70,-,,260602
2015-16,Boston Jr. Bruins Selects U18,MHSL U18,11,8,16,24,2,,260602
2015-16,Sudbury Wolves,OHL,68,30,22,52,13,-40,279385
2015-16,Malmö Redhawks J20,SuperElit,43,11,20,31,16,8,212529
2015-16,Malmö Redhawks,SHL,5,0,0,0,2,0,212529
2015-16,Tyringe SoSS,Division 1,2,1,1,2,0,0,212529
2015-16,Newmarket Hurricanes,OJHL,32,5,9,14,38,,259294
2015-16,Bowling Green State Univ.,NCAA,22,1,2,3,8,4,259294
2015-16,Canada East U19,WJAC-19,5,2,0,2,8,,259294
2015-16,Djurgårdens IF J20,SuperElit,45,10,28,38,30,13,187875
2015-16,Djurgårdens IF J20,JCWC,5,1,1,2,6,2,187875
2015-16,Medicine Hat Tigers,WHL,64,14,41,55,30,-21,166662
2015-16,Canada U18,WJC-18,7,5,3,8,4,7,166662
2015-16,Team White,U18-Dev,3,0,1,1,0,,166662
2015-16,Canada U18,Hlinka Memorial,4,0,1,1,0,3,166662
2015-16,Vancouver Giants,WHL,67,31,28,59,18,-7,195952
2015-16,Owen Sound Attack,OHL,54,4,17,21,106,10,253249
2015-16,Sioux City Musketeers,USHL,29,3,11,14,8,-6,297332
2015-16,Waterloo Black Hawks,USHL,18,4,16,20,4,-1,297332
2015-16,Team Red,USA-S17,5,0,1,1,2,,297332
2015-16,Kelowna Rockets,WHL,45,1,1,2,40,-6,247979
2015-16,Victoria Royals,WHL,72,46,39,85,27,34,199395
2015-16,Halifax Mooseheads,QMJHL,59,13,33,46,25,-15,196406
2015-16,Finland U18,WJC-18,7,1,1,2,2,4,196406
2015-16,Finland U18,Hlinka Memorial,5,1,2,3,14,1,196406
2015-16,Wilkes-Barre/Scranton Knights,NAHL,53,7,15,22,74,-3,312205
2015-16,Russia U18,WJC-18,5,0,1,1,2,0,312205
2015-16,Madison Capitols,USHL,48,16,23,39,50,1,79424
2015-16,Waterloo Black Hawks,USHL,14,7,11,18,4,4,79424
2015-16,Rødovre SIK,Denmark2,9,5,8,13,2,,207452
2015-16,Rødovre Mighty Bulls,Denmark,30,2,2,4,10,-1,207452
2015-16,Denmark U18,WJC-18,7,1,5,6,6,-10,207452
2015-16,Denmark U18 (all),International-Jr,8,1,5,6,6,,207452
2015-16,Denmark U20,WJC-20,5,0,1,1,0,-4,207452
2015-16,Denmark U20 (all),International-Jr,13,0,2,2,4,,207452
2015-16,Rødovre Mighty Bulls,Danish Cup,1,0,0,0,0,,207452
2015-16,Malmö Redhawks J18,J18 Elit,1,0,0,0,2,1,211282
2015-16,Malmö Redhawks J18,J18 Allsvenskan,2,0,0,0,0,-1,211282
2015-16,Malmö Redhawks J20,SuperElit,45,15,13,28,10,1,211282
2015-16,Denmark U18,WJC-18,7,4,2,6,2,-11,211282
2015-16,Denmark U18 (all),International-Jr,14,12,3,15,4,,211282
2015-16,HC Litvinov U18,Czech U18,42,20,26,46,48,17,167520
2015-16,HC Litvinov U20,Czech U20,7,0,3,3,2,4,167520
2016-17,Halifax Mooseheads,QMJHL,57,38,48,86,24,20,116244
2016-17,Switzerland U18,WJC-18,5,1,5,6,0,0,116244
2016-17,Switzerland U18 (all),International-Jr,9,3,8,11,2,,116244
2016-17,Switzerland U20,WJC-20,5,4,3,7,2,-1,116244
2016-17,Switzerland U20 (all),International-Jr,11,7,8,15,4,,116244
2016-17,Switzerland U18,Hlinka Memorial,3,1,1,2,2,-4,116244
2016-17,Brandon Wheat Kings,WHL,33,20,26,46,36,9,201274
2016-17,HIFK,Liiga,37,5,5,10,4,-1,250075
2016-17,Finland U18,WJC-18,7,2,10,12,0,8,250075
2016-17,Finland U18 (all),International-Jr,7,2,10,12,0,,250075
2016-17,Finland U20,WJC-20,6,0,1,1,0,-2,250075
2016-17,Finland U20 (all),International-Jr,21,0,4,4,0,1,250075
2016-17,HIFK,Champions HL,6,0,3,3,0,3,250075
2016-17,Brooks Bandits,AJHL,54,24,51,75,18,,199655
2016-17,Canada West U19,WJAC-19,4,4,4,8,0,,199655
2016-17,Brooks Bandits,Western Canada Cup,5,3,5,8,2,,199655
2016-17,Brooks Bandits,RBC Cup,5,2,4,6,2,,199655
2016-17,Timrå IK J20,SuperElit,0,0,0,0,0,0,266336
2016-17,Timrå IK,Allsvenskan,43,19,22,41,14,15,266336
2016-17,Sweden U20,WJC-20,6,0,1,1,0,1,266336
2016-17,Sweden U20 (all),International-Jr,14,4,6,10,2,4,266336
2016-17,Portland Winterhawks,WHL,69,32,62,94,36,31,201704
2016-17,Canada U18,WJC-18,3,2,1,3,0,-1,201704
2016-17,HV71 J20,SuperElit,3,2,0,2,2,1,214318
2016-17,HV71,SHL,42,9,10,19,18,21,214318
2016-17,Sweden U20,WJC-20,7,3,0,3,6,2,214318
2016-17,Sweden U20 (all),International-Jr,17,6,9,15,14,6,214318
2016-17,HV71,Champions HL,7,0,1,1,2,0,214318
2016-17,Eden Prairie High,USHS-MN,25,21,43,64,8,,300831
2016-17,Green Bay Gamblers,USHL,24,13,17,30,2,3,300831
2016-17,Eden Prairie High,MN State,3,1,2,3,2,,300831
2016-17,Tri-City Americans,WHL,50,32,23,55,50,-13,286738
2016-17,Canada U18,Hlinka Memorial,4,1,3,4,8,1,286738
2016-17,Mississauga Steelheads,OHL,60,44,31,75,36,24,201664
2016-17,Canada U18,Hlinka Memorial,4,1,1,2,0,1,201664
2016-17,OHL All-Stars,Jr Super Series,1,0,2,2,0,0,201664
2016-17,Windsor Spitfires,OHL,49,29,32,61,12,13,286867
2016-17,Windsor Spitfires,M-Cup,4,0,7,7,0,2,286867
2016-17,OHL All-Stars,Jr Super Series,1,0,0,0,0,0,286867
2016-17,HC Kometa Brno U20,Czech U20,1,1,2,3,4,2,237071
2016-17,HC Kometa Brno,Czech,41,7,8,15,6,-2,237071
2016-17,SK Horacka Slavia Trebic,Czech2,0,0,0,0,0,,237071
2016-17,Czech Republic U18,WJC-18,5,0,3,3,4,-1,237071
2016-17,Czech Republic U18 (all),International-Jr,15,4,9,13,6,4,237071
2016-17,Czech Republic U20,WJC-20,5,1,2,3,2,2,237071
2016-17,Czech Republic U20 (all),International-Jr,8,2,4,6,2,0,237071
2016-17,Czech Republic U18,Hlinka Memorial,5,2,4,6,2,4,237071
2016-17,Owen Sound Attack,OHL,65,45,51,96,10,51,300436
2016-17,Canada U18,Hlinka Memorial,4,1,2,3,0,1,300436
2016-17,Kelowna Rockets,WHL,71,6,51,57,41,39,247895
2016-17,WHL All-Stars,Jr Super Series,2,0,0,0,2,-1,247895
2016-17,HV71 J20,SuperElit,19,9,14,23,18,13,255167
2016-17,HV71,SHL,35,1,5,6,2,10,255167
2016-17,Sweden U18,WJC-18,7,2,3,5,0,-5,255167
2016-17,Sweden U18 (all),International-Jr,17,7,5,12,39,-12,255167
2016-17,Sweden U20 (all),International-Jr,3,0,3,3,2,-1,255167
2016-17,Sweden U18,Hlinka Memorial,5,2,1,3,31,-4,255167
2016-17,HV71,Champions HL,1,0,0,0,0,0,255167
2016-17,Tri-City Americans,WHL,60,19,42,61,34,2,221525
2016-17,Finland U20,WJC-20,6,2,0,2,6,1,221525
2016-17,Finland U20 (all),International-Jr,15,4,1,5,16,3,221525
2016-17,Rögle BK J18,J18 Allsvenskan,0,0,0,0,0,,224910
2016-17,Rögle BK J20,SuperElit,12,5,2,7,8,-7,224910
2016-17,Rögle BK,SHL,19,1,4,5,4,-3,224910
2016-17,Timrå IK,Allsvenskan,5,0,1,1,4,-2,224910
2016-17,Sweden U18,WJC-18,7,0,2,2,4,-5,224910
2016-17,Sweden U18 (all),International-Jr,17,1,9,10,8,-7,224910
2016-17,Sweden U18,Hlinka Memorial,5,1,3,4,2,-1,224910
2016-17,JYP U20,Jr. A SM-liiga,1,0,0,0,0,-1,180538
2016-17,JYP,Liiga,41,2,4,6,12,5,180538
2016-17,JYP-Akatemia,Mestis,3,0,1,1,29,-2,180538
2016-17,Finland U18,WJC-18,5,3,3,6,2,4,180538
2016-17,Finland U18 (all),International-Jr,8,3,3,6,4,,180538
2016-17,Finland U20,WJC-20,6,1,0,1,4,-2,180538
2016-17,Finland U20 (all),International-Jr,9,2,1,3,4,-1,180538
2016-17,JYP,Champions HL,5,0,1,1,4,2,180538
2016-17,Finland U18,Hlinka Memorial,4,0,1,1,2,-1,180538
2016-17,USNTDP Juniors,USHL,25,12,14,26,18,9,273954
2016-17,U.S. National U18 Team,USDP,61,27,34,61,36,,273954
2016-17,USA U18,WJC-18,7,3,4,7,2,5,273954
2016-17,London Knights,OHL,66,16,50,66,26,41,201681
2016-17,HC Zlin U20,Czech U20,2,0,0,0,0,-1,236806
2016-17,HC Zlin,Czech,38,4,4,8,16,-5,236806
2016-17,Czech Republic U18,WJC-18,5,2,3,5,2,-1,236806
2016-17,Czech Republic U18 (all),International-Jr,19,6,7,13,10,1,236806
2016-17,Czech Republic U18,Hlinka Memorial,5,3,1,4,0,1,236806
2016-17,Spokane Chiefs,WHL,65,42,57,99,46,14,247915
2016-17,Charlottetown Islanders,QMJHL,62,6,33,39,54,14,284911
2016-17,Frölunda HC J20,SuperElit,10,4,0,4,14,-7,222125
2016-17,Frölunda HC,SHL,26,1,5,6,2,-1,222125
2016-17,HPK,Liiga,9,1,0,1,0,-1,222125
2016-17,Finland U18,WJC-18,7,6,7,13,8,5,222125
2016-17,Finland U18 (all),International-Jr,9,6,7,13,10,,222125
2016-17,Finland U20,WJC-20,6,1,1,2,0,-4,222125
2016-17,Finland U20 (all),International-Jr,12,4,3,7,4,-4,222125
2016-17,Frölunda HC,Champions HL,6,2,1,3,0,3,222125
2016-17,St. Cloud State Univ.,NCAA,35,7,6,13,12,-8,288045
2016-17,U.S. National U18 Team,USDP,9,4,2,6,4,,288045
2016-17,USA U18,WJC-18,7,3,2,5,6,4,288045
2016-17,Team Columbia,USA-S17,5,2,3,5,-,,288045
2016-17,USA U18,Hlinka Memorial,4,4,2,6,6,1,288045
2016-17,Sault Ste. Marie Greyhounds,OHL,67,20,42,62,36,15,317025
2016-17,Waterloo Black Hawks,USHL,60,22,29,51,20,14,216102
2016-17,Canada U18,Hlinka Memorial,4,1,0,1,0,1,216102
2016-17,Portland Winterhawks,WHL,71,9,39,48,38,14,277056
2016-17,Finland U20 (all),International-Jr,7,0,1,1,0,3,277056
2016-17,Sioux City Musketeers,USHL,52,30,24,54,26,18,249730
2016-17,Finland U20,WJC-20,6,2,4,6,2,-1,249730
2016-17,Finland U20 (all),International-Jr,15,7,9,16,8,2,249730
2016-17,Dynamo Moskva,KHL,8,0,0,0,27,1,312823
2016-17,Dynamo Balashikha,VHL,9,1,0,1,4,-1,312823
2016-17,HK MVD Balashikha,MHL,1,0,1,1,2,0,312823
2016-17,Russia U18,Hlinka Memorial,5,4,3,7,29,1,312823
2016-17,Russia U18,WJAC-19,3,1,2,3,6,,312823
2016-17,Russian Selects U20,Jr Super Series,5,1,1,2,8,-2,312823
2016-17,Sault Ste. Marie Greyhounds,OHL,67,7,54,61,69,53,267584
2016-17,Kelowna Rockets,WHL,70,30,57,87,79,36,200933
2016-17,Mississauga Steelheads,OHL,65,18,28,46,107,22,253977
2016-17,OHL All-Stars,Jr Super Series,2,0,0,0,2,-1,253977
2016-17,Guelph Storm,OHL,67,28,26,54,65,-2,300398
2016-17,Canada U18,WJC-18,5,2,0,2,6,4,300398
2016-17,Brynäs IF J20,SuperElit,15,10,5,15,6,7,212690
2016-17,Brynäs IF,SHL,16,0,6,6,2,6,212690
2016-17,Timrå IK,Allsvenskan,19,3,9,12,0,0,212690
2016-17,Sweden U19 (all),International-Jr,4,4,4,8,0,2,212690
2016-17,Djurgårdens IF J20,SuperElit,9,6,4,10,2,5,240720
2016-17,Djurgårdens IF,SHL,45,5,4,9,6,-4,240720
2016-17,Sweden U20 (all),International-Jr,10,1,2,3,6,0,240720
2016-17,Djurgårdens IF,Champions HL,3,0,0,0,2,0,240720
2016-17,Almtuna IS J20,J20 Elit,6,6,4,10,10,9,212379
2016-17,Almtuna IS,Allsvenskan,48,2,7,9,26,-11,212379
2016-17,Sweden U19 (all),International-Jr,4,1,6,7,6,1,212379
2016-17,Kingston Frontenacs,OHL,68,42,39,81,29,3,201455
2016-17,Swift Current Broncos,WHL,72,28,58,86,18,15,284816
2016-17,Finland U18 (all),International-Jr,3,0,3,3,0,,284816
2016-17,Finland U18,Hlinka Memorial,4,0,5,5,0,1,284816
2016-17,Spokane Chiefs,WHL,72,39,37,76,22,4,278859
2016-17,Canada U18,WJC-18,5,0,0,0,4,-4,278859
2016-17,KalPa U20,Jr. A SM-liiga,23,11,8,19,49,8,299319
2016-17,KalPa,Liiga,32,3,4,7,14,2,299319
2016-17,Finland U20 (all),International-Jr,7,1,4,5,2,3,299319
2016-17,Hermantown High,USHS-MN,25,10,18,28,43,,201527
2016-17,Team North,USHS-MN,18,5,7,12,14,,201527
2016-17,Waterloo Black Hawks,USHL,6,1,1,2,0,2,201527
2016-17,Team White,USA-S17,5,0,2,2,-,,201527
2016-17,Hermantown High,MN State,3,1,3,4,0,,201527
2016-17,Frölunda HC J18,J18 Allsvenskan,0,0,0,0,0,,262145
2016-17,Frölunda HC J20,SuperElit,23,1,6,7,8,-4,262145
2016-17,Frölunda HC,SHL,33,0,4,4,6,3,262145
2016-17,Sweden U18,WJC-18,7,1,1,2,4,3,262145
2016-17,Sweden U18 (all),International-Jr,16,1,3,4,10,5,262145
2016-17,Frölunda HC,Champions HL,7,0,0,0,0,1,262145
2016-17,Grenoble,France,40,10,9,19,69,-1,296904
2016-17,France U18,WJC-18 D1A,5,2,3,5,6,3,296904
2016-17,France U20,WJC-20 D1A,5,1,7,8,4,1,296904
2016-17,France (all),International,6,2,2,4,4,,296904
2016-17,Sport,Liiga,54,1,15,16,14,0,197821
2016-17,Finland U20 (all),International-Jr,11,0,1,1,10,0,197821
2016-17,London Knights,OHL,65,16,18,34,50,21,273622
2016-17,SKA-Neva St. Petersburg,VHL,15,3,0,3,4,2,277802
2016-17,SKA-1946 St. Petersburg,MHL,16,6,5,11,12,6,277802
2016-17,Russian Selects U20,Jr Super Series,6,0,3,3,0,-1,277802
2016-17,Des Moines Buccaneers,USHL,60,8,33,41,42,7,245622
2016-17,Victoriaville Tigres,QMJHL,64,22,29,51,88,-7,201534
2016-17,Canada U18,WJC-18,5,2,0,2,28,-5,201534
2016-17,Canada U18,Hlinka Memorial,4,4,1,5,8,3,201534
2016-17,QMJHL All-Stars,Jr Super Series,1,2,0,2,0,1,201534
2016-17,Rouyn-Noranda Huskies,QMJHL,63,3,18,21,90,42,254662
2016-17,Univ. of Michigan,NCAA,35,1,6,7,12,2,272217
2016-17,Oshawa Generals,OHL,64,18,34,52,36,-6,284096
2016-17,Canada U18,WJC-18,3,3,0,3,0,-1,284096
2016-17,Canada U18,Hlinka Memorial,4,0,0,0,0,0,284096
2016-17,Owen Sound Attack,OHL,60,46,28,74,32,35,252476
2016-17,Moose Jaw Warriors,WHL,69,8,32,40,61,17,201551
2016-17,Canada U18,WJC-18,5,0,2,2,4,2,201551
2016-17,Canada U18,Hlinka Memorial,4,0,0,0,0,0,201551
2016-17,Spruce Grove Saints,AJHL,53,8,29,37,34,,201362
2016-17,Canada U18,WJC-18,5,0,2,2,0,-3,201362
2016-17,Canada U18,Hlinka Memorial,4,2,1,3,0,4,201362
2016-17,Canada West U19,WJAC-19,4,1,2,3,2,,201362
2016-17,Frölunda HC J18,J18 Allsvenskan,4,2,3,5,0,2,221341
2016-17,Frölunda HC J20,SuperElit,40,22,19,41,42,8,221341
2016-17,Frölunda HC,SHL,10,0,0,0,0,1,221341
2016-17,Finland U18,WJC-18,7,4,4,8,8,4,221341
2016-17,Finland U18 (all),International-Jr,21,11,12,23,16,,221341
2016-17,Frölunda HC,Champions HL,3,0,0,0,0,-1,221341
2016-17,Kingston Frontenacs,OHL,66,6,33,39,41,-7,302228
2016-17,Finland U18,WJC-18,6,1,0,1,2,0,302228
2016-17,Finland U18 (all),International-Jr,9,1,0,1,4,,302228
2016-17,Finland U18,Hlinka Memorial,4,0,1,1,2,2,302228
2016-17,Acadie-Bathurst Titan,QMJHL,67,28,46,74,52,21,275608
2016-17,QMJHL All-Stars,Jr Super Series,1,0,0,0,0,0,275608
2016-17,USNTDP Juniors,USHL,26,8,16,24,44,12,269306
2016-17,U.S. National U18 Team,USDP,65,26,35,61,106,,269306
2016-17,USA U18,WJC-18,7,3,5,8,10,4,269306
2016-17,Regina Pats,WHL,47,17,23,40,22,14,279125
2016-17,Färjestad BK J18,J18 Allsvenskan,0,0,0,0,0,,265608
2016-17,Färjestad BK J20,SuperElit,40,16,20,36,18,11,265608
2016-17,Färjestad BK,SHL,14,0,0,0,2,-1,265608
2016-17,Sweden U18,WJC-18,7,3,2,5,0,1,265608
2016-17,Sweden U18 (all),International-Jr,21,5,11,16,31,-3,265608
2016-17,Sweden U18,Hlinka Memorial,5,1,2,3,27,-4,265608
2016-17,Växjö Lakers HC J18,J18 Elit,1,1,0,1,0,2,220099
2016-17,Växjö Lakers HC J20,SuperElit,42,9,22,31,4,13,220099
2016-17,Växjö Lakers HC,SHL,5,0,0,0,0,0,220099
2016-17,Denmark U18,WJC-18 D1A,5,4,5,9,2,-2,220099
2016-17,Denmark U18 (all),International-Jr,11,10,6,16,2,,220099
2016-17,Denmark U20,WJC-20,5,0,2,2,0,0,220099
2016-17,Denmark U20 (all),International-Jr,11,1,4,5,0,,220099
2016-17,Växjö Lakers HC,Champions HL,4,0,0,0,0,0,220099
2016-17,USNTDP Juniors,USHL,26,5,9,14,28,5,272169
2016-17,U.S. National U18 Team,USDP,63,11,21,32,56,16,272169
2016-17,USA U18,WJC-18,7,4,2,6,4,5,272169
2016-17,Tri-City Americans,WHL,72,35,55,90,40,22,247912
2016-17,Victoria Royals,WHL,60,6,24,30,36,-13,258428
2016-17,Hamilton Bulldogs,OHL,54,12,13,25,25,0,273678
2016-17,Canada U18,WJC-18,5,4,3,7,6,1,273678
2016-17,Canada U18,Hlinka Memorial,4,0,1,1,4,-1,273678
2016-17,SKA-Neva St. Petersburg,VHL,27,5,4,9,10,5,313706
2016-17,Serebryanye Lvy St. Petersburg,MHL,31,20,25,45,77,23,313706
2016-17,Sioux Falls Stampede,USHL,47,1,11,12,43,12,221328
2016-17,Finland U20 (all),International-Jr,13,2,4,6,8,0,221328
2016-17,Brandon Wheat Kings,WHL,69,26,35,61,59,-16,201293
2016-17,Canada U18,WJC-18,5,4,0,4,2,-5,201293
2016-17,Canada U18,Hlinka Memorial,4,1,0,1,4,1,201293
2016-17,Merrimack College,NCAA,36,3,16,19,30,7,239820
2016-17,Guelph Storm,OHL,54,18,18,36,27,-19,283248
2016-17,Canada U18,WJC-18,5,0,1,1,0,0,283248
2016-17,Dynamo Balashikha,VHL,21,3,5,8,8,5,312824
2016-17,HK MVD Balashikha,MHL,11,0,3,3,6,0,312824
2016-17,Russia U18,WJC-18,7,0,3,3,0,3,312824
2016-17,Russia U18,Hlinka Memorial,5,0,5,5,0,4,312824
2016-17,Russia U18,WJAC-19,4,4,4,8,0,,312824
2016-17,Bloomington Thunder,USHL,45,1,9,10,18,-2,313516
2016-17,Chicago Steel,USHL,14,1,8,9,4,-6,313516
2016-17,Team Orange,USA-S17,5,2,0,2,-,,313516
2016-17,USA U18,Hlinka Memorial,4,0,0,0,2,-4,313516
2016-17,Regina Pats,WHL,33,9,16,25,48,18,247919
2016-17,Red Deer Rebels,WHL,31,19,10,29,49,-5,247919
2016-17,Proctor Academy,USHS-Prep,30,30,39,69,-,,300597
2016-17,Chicago Steel,USHL,24,2,8,10,12,7,300597
2016-17,Team Columbia,USA-S17,5,0,4,4,-,,300597
2016-17,USA U18,Hlinka Memorial,4,0,0,0,2,1,300597
2016-17,Brockville Braves,CCHL,41,4,9,13,32,,299556
2016-17,Canada East U19,WJAC-19,4,0,0,0,2,,299556
2016-17,Peterborough Petes,OHL,60,21,26,47,74,4,273617
2016-17,Guelph Storm,OHL,67,4,16,20,41,-24,312819
2016-17,Russia U18,WJC-18,7,1,4,5,6,2,312819
2016-17,Russia U18,Hlinka Memorial,5,0,2,2,16,1,312819
2016-17,Erie Otters,OHL,66,24,33,57,24,21,201450
2016-17,Team Kelly,USA-S17,5,4,4,8,-,,201450
2016-17,Erie Otters,M-Cup,5,1,2,3,0,-1,201450
2016-17,USA U18,Hlinka Memorial,4,3,1,4,0,0,201450
2016-17,Kootenay Ice,WHL,70,11,27,38,67,-61,200710
2016-17,Ilves U18,Jr. B SM-sarja,10,0,10,10,12,,372926
2016-17,Ilves U20,Jr. A SM-liiga,27,6,3,9,14,9,372926
2016-17,USNTDP Juniors,USHL,26,9,15,24,28,8,303599
2016-17,U.S. National U18 Team,USDP,63,18,38,56,76,,303599
2016-17,USA U18,WJC-18,7,1,5,6,6,5,303599
2016-17,Chicago Steel,USHL,59,28,14,42,38,14,229589
2016-17,USNTDP Juniors,USHL,25,1,16,17,22,8,269310
2016-17,U.S. National U18 Team,USDP,64,7,30,37,38,,269310
2016-17,USA U18,WJC-18,7,2,1,3,0,2,269310
2016-17,Fargo Force,USHL,56,7,13,20,35,18,353590
2016-17,Team Gold,USA-S17,5,0,1,1,-,,353590
2016-17,USA U18,Hlinka Memorial,4,0,1,1,2,2,353590
2016-17,USA U19,WJAC-19,5,1,1,2,0,,353590
2016-17,Regina Pats,WHL,72,35,46,81,49,32,201705
2016-17,Dexter School,USHS-Prep,22,16,19,35,-,,311766
2016-17,Youngstown Phantoms,USHL,4,0,1,1,0,1,311766
2016-17,Cape Cod Whalers U18,MHSL U18,14,4,8,12,8,,311766
2016-17,Cape Cod Whalers U18,Midget,23,8,10,18,-,,311766
2016-17,Team Royal,USA-S17,5,0,1,1,-,,311766
2016-17,Medicine Hat Tigers,WHL,71,27,67,94,57,12,162926
2016-17,WHL All-Stars,Jr Super Series,2,0,0,0,0,0,162926
2016-17,Moose Jaw Warriors,WHL,40,22,29,51,14,3,312680
2016-17,Prince George Cougars,WHL,31,7,11,18,15,9,312680
2016-17,Russian Selects U20,Jr Super Series,2,0,1,1,2,0,312680
2016-17,Providence College,NCAA,39,3,17,20,12,0,253923
2016-17,Malmö Redhawks J18,J18 Elit,7,2,3,5,6,5,265424
2016-17,Malmö Redhawks J18,J18 Allsvenskan,3,2,2,4,4,2,265424
2016-17,Malmö Redhawks J20,SuperElit,38,2,10,12,18,7,265424
2016-17,Denmark U18,WJC-18 D1A,5,1,1,2,2,0,265424
2016-17,Denmark U18 (all),International-Jr,16,2,7,9,6,,265424
2016-17,Sault Ste. Marie Greyhounds,OHL,38,6,8,14,18,9,297961
2016-17,Guelph Storm,OHL,28,3,11,14,22,-12,297961
2016-17,Canada U18,WJC-18,5,0,0,0,4,1,297961
2016-17,USNTDP Juniors,USHL,21,10,4,14,39,9,269301
2016-17,U.S. National U18 Team,USDP,60,22,20,42,51,,269301
2016-17,USA U18,WJC-18,7,1,1,2,2,2,269301
2016-17,Waterloo Black Hawks,USHL,54,5,29,34,52,29,201512
2016-17,Team Grey,USA-S17,5,1,1,2,-,,201512
2016-17,USA U18,Hlinka Memorial,4,0,0,0,0,3,201512
2016-17,USA U19,WJAC-19,5,0,0,0,4,,201512
2016-17,TPS U18,Jr. B SM-sarja,0,0,0,0,0,,283531
2016-17,TPS U20,Jr. A SM-liiga,5,2,4,6,0,-1,283531
2016-17,Finland U18,WJC-18,7,2,4,6,2,5,283531
2016-17,Finland U18 (all),International-Jr,12,5,5,10,4,,283531
2016-17,Finland U18,Hlinka Memorial,4,1,1,2,2,-1,283531
2016-17,Hamilton Bulldogs,OHL,66,34,28,62,62,9,268417
2016-17,Canada U18,WJC-18,5,1,2,3,6,4,268417
2016-17,Canada U18,Hlinka Memorial,4,1,0,1,2,1,268417
2016-17,Owen Sound Attack,OHL,54,17,15,32,24,10,313615
2016-17,Belarus U20,WJC-20 D1A,5,1,0,1,0,1,313615
2016-17,Ottawa 67's,OHL,62,14,26,40,36,-13,201670
2016-17,Sarnia Sting,OHL,61,25,21,46,30,-15,228366
2016-17,Slovakia U18,WJC-18,5,2,3,5,6,-1,228366
2016-17,Slovakia U20,WJC-20,5,1,0,1,2,-4,228366
2016-17,Slovakia U20 (all),International-Jr,2,1,2,3,0,0,228366
2016-17,Slovakia U18,Hlinka Memorial,4,2,2,4,2,2,228366
2016-17,Skellefteå AIK J20,SuperElit,6,2,3,5,4,-1,188028
2016-17,Skellefteå AIK,SHL,39,3,4,7,8,-2,188028
2016-17,Sweden U20,WJC-20,7,2,1,3,4,-2,188028
2016-17,Sweden U20 (all),International-Jr,12,2,1,3,8,-2,188028
2016-17,Skellefteå AIK,Champions HL,5,0,0,0,2,-3,188028
2016-17,Dynamo Balashikha,VHL,1,0,0,0,0,0,312825
2016-17,HK MVD Balashikha,MHL,45,19,12,31,50,-4,312825
2016-17,Russia U18,WJC-18,7,0,2,2,2,-1,312825
2016-17,Russia U18,Hlinka Memorial,5,0,0,0,0,-3,312825
2016-17,HC Sparta Praha U18,Czech U18,1,0,0,0,0,-1,272770
2016-17,HC Sparta Praha U20,Czech U20,24,6,12,18,66,6,272770
2016-17,HC Sparta Praha,Czech,8,1,1,2,2,2,272770
2016-17,HC Litomerice,Czech2,3,0,0,0,0,-1,272770
2016-17,Czech Republic U18,WJC-18,5,1,3,4,2,-1,272770
2016-17,Czech Republic U18 (all),International-Jr,23,8,8,16,16,2,272770
2016-17,HC Sparta Praha U20,JCWC,4,1,1,2,0,-2,272770
2016-17,HC Sparta Praha,Champions HL,2,0,0,0,0,0,272770
2016-17,Czech Republic U18,Hlinka Memorial,5,3,1,4,2,1,272770
2016-17,Oakville Blades,OJHL,46,26,36,62,14,,273632
2016-17,Canada East U19,WJAC-19,4,0,1,1,4,,273632
2016-17,Leksands IF J18,J18 Allsvenskan,0,0,0,0,0,0,313359
2016-17,Leksands IF J20,SuperElit,28,21,12,33,35,3,313359
2016-17,Leksands IF,SHL,5,0,0,0,0,-1,313359
2016-17,Sweden U18,WJC-18,7,1,1,2,2,0,313359
2016-17,Sweden U18 (all),International-Jr,17,4,4,8,18,-1,313359
2016-17,Sweden U18,Hlinka Memorial,5,1,1,2,0,1,313359
2016-17,Owen Sound Attack,OHL,66,13,30,43,44,41,201660
2016-17,Canada U18,Hlinka Memorial,4,0,1,1,6,0,201660
2016-17,OHL All-Stars,Jr Super Series,1,0,0,0,0,1,201660
2016-17,Jokerit U20,Jr. A SM-liiga,48,5,16,21,42,3,249738
2016-17,Finland U20 (all),International-Jr,11,2,2,4,4,7,249738
2016-17,Jokerit U20,JCWC,6,0,1,1,37,0,249738
2016-17,Zug U20,Elite Jr. A,3,1,2,3,0,,274212
2016-17,EV Zug,NLA,14,0,1,1,0,-3,274212
2016-17,EVZ Academy,NLB,34,3,7,10,14,-6,274212
2016-17,Switzerland U18,WJC-18,5,0,0,0,0,-6,274212
2016-17,Switzerland U18 (all),International-Jr,14,0,4,4,2,,274212
2016-17,Switzerland U20 (all),International-Jr,10,0,2,2,0,,274212
2016-17,EV Zug,Champions HL,2,0,0,0,0,0,274212
2016-17,EV Zug,Swiss Cup,3,0,0,0,0,,274212
2016-17,Switzerland U18,Hlinka Memorial,4,0,1,1,2,-7,274212
2016-17,Cape Breton Screaming Eagles,QMJHL,61,22,36,58,70,16,195192
2016-17,Tri-City Americans,WHL,72,20,37,57,52,25,161063
2016-17,Canada U18,WJC-18,5,2,1,3,18,4,161063
2016-17,London Knights,OHL,61,7,20,27,114,53,258636
2016-17,Bars Kazan,VHL,34,3,5,8,4,-7,322627
2016-17,Irbis Kazan,MHL,31,11,9,20,10,5,322627
2016-17,Metallurg Magnitogorsk,KHL,10,0,0,0,2,0,312234
2016-17,Stalnye Lisy Magnitogorsk,MHL,40,21,49,70,26,38,312234
2016-17,Youngstown Phantoms,USHL,58,4,17,21,39,9,350368
2016-17,Rögle BK J18,J18 Allsvenskan,1,0,0,0,0,-1,290074
2016-17,Rögle BK J20,SuperElit,41,15,30,45,22,1,290074
2016-17,Rögle BK,SHL,12,0,0,0,0,-1,290074
2016-17,Sweden U18,WJC-18,7,0,3,3,2,-2,290074
2016-17,Sweden U18 (all),International-Jr,21,5,7,12,8,-1,290074
2016-17,Sweden U18,Hlinka Memorial,5,1,2,3,2,0,290074
2016-17,Swift Current Broncos,WHL,72,51,39,90,22,26,131215
2016-17,Chicoutimi Saguenéens,QMJHL,36,3,11,14,23,-7,284907
2016-17,Val-d'Or Foreurs,QMJHL,29,8,10,18,6,-9,284907
2016-17,Canada U18,WJC-18,4,0,0,0,0,-1,284907
2016-17,Peterborough Petes,OHL,61,6,13,19,82,4,297963
2016-17,Frölunda HC J18,J18 Elit,7,10,6,16,4,12,313350
2016-17,Frölunda HC J18,J18 Allsvenskan,3,3,1,4,6,3,313350
2016-17,Frölunda HC J20,SuperElit,44,15,12,27,8,0,313350
2016-17,Sweden U18,WJC-18,7,1,1,2,2,-1,313350
2016-17,Sweden U18 (all),International-Jr,12,3,2,5,2,3,313350
2016-17,USNTDP Juniors,USHL,17,2,5,7,49,7,201486
2016-17,U.S. National U18 Team,USDP,51,2,11,13,108,,201486
2016-17,USA U18,WJC-18,7,0,0,0,6,6,201486
2016-17,Team Forest,USA-S17,5,0,1,1,-,,201486
2016-17,USA U18,Hlinka Memorial,4,0,0,0,14,2,201486
2016-17,Madison Capitols,USHL,59,6,26,32,112,-24,300850
2016-17,Frölunda HC J20,SuperElit,4,0,0,0,0,-5,212814
2016-17,Frölunda HC,SHL,10,0,0,0,29,2,212814
2016-17,IK Oskarshamn,Allsvenskan,29,1,1,2,8,-5,212814
2016-17,Sweden U20,WJC-20,7,0,1,1,2,3,212814
2016-17,Sweden U20 (all),International-Jr,20,1,1,2,8,5,212814
2016-17,Frölunda HC,Champions HL,3,0,0,0,2,0,212814
2016-17,Cape Breton Screaming Eagles,QMJHL,54,8,24,32,26,11,243313
2016-17,Germany U18 (all),International-Jr,-,-,-,-,-,,243313
2016-17,Germany U20,WJC-20 D1A,4,0,1,1,0,2,243313
2016-17,Stillwater High,USHS-MN,25,20,45,65,10,,201517
2016-17,Team Northeast,USHS-MN,21,9,15,24,10,,201517
2016-17,Omaha Lancers,USHL,11,2,5,7,6,-3,201517
2016-17,Team Gold,USA-S17,5,1,2,3,-,,201517
2016-17,Ottawa 67's,OHL,37,15,14,29,41,-2,268925
2016-17,Sarnia Sting,OHL,28,20,13,33,39,-2,268925
2016-17,Skellefteå AIK,SHL,50,10,20,30,10,-6,67208
2016-17,Sweden,EHT,5,0,0,0,2,-1,67208
2016-17,Sweden (all),International,12,1,0,1,8,-2,67208
2016-17,Skellefteå AIK,Champions HL,6,1,3,4,0,0,67208
2016-17,Medicine Hat Tigers,WHL,62,34,29,63,145,10,153108
2016-17,Hamilton Bulldogs,OHL,2,1,0,1,2,4,273797
2016-17,Flint Firebirds,OHL,62,3,10,13,43,-7,273797
2016-17,Northwood School Junior,USHS-Prep,47,28,52,80,-,,345694
2016-17,Hamilton Bulldogs,OHL,58,18,12,30,23,-11,305485
2016-17,Slovakia U20,WJC-20,5,0,0,0,4,-4,305485
2016-17,Brooks Bandits,AJHL,60,34,32,66,58,,153054
2016-17,Brooks Bandits,RBC Cup,5,2,3,5,8,,153054
2016-17,Östersunds IK,Division 1,34,5,10,15,26,12,266116
2016-17,Timrå IK J20,SuperElit,1,0,1,1,0,-1,266116
2016-17,Timrå IK,Allsvenskan,2,0,0,0,0,-1,266116
2016-17,Sweden U18,WJC-18,6,0,0,0,2,4,266116
2016-17,Sweden U18 (all),International-Jr,14,0,1,1,6,4,266116
2016-17,Saginaw Spirit,OHL,37,6,10,16,26,9,273658
2016-17,Niagara IceDogs,OHL,29,15,7,22,15,-10,273658
2016-17,Russia U18,WJC-18,7,3,0,3,2,2,273658
2016-17,London Knights,OHL,38,0,2,2,0,3,201654
2016-17,Trail Smoke Eaters,BCHL,51,30,28,58,46,0,131227
2016-17,Seattle Thunderbirds,WHL,54,6,19,25,28,5,297994
2016-17,Seattle Thunderbirds,M-Cup,3,0,0,0,2,-8,297994
2016-17,HC Olomouc U18,Czech U18,3,1,4,5,0,1,236429
2016-17,HC Olomouc U20,Czech U20,5,1,4,5,0,0,236429
2016-17,HC Olomouc,Czech,36,1,5,6,14,-7,236429
2016-17,HC Dukla Jihlava,Czech2,-,-,-,-,-,,236429
2016-17,Czech Republic U18,WJC-18,2,0,1,1,0,0,236429
2016-17,Czech Republic U18 (all),International-Jr,17,2,7,9,4,6,236429
2016-17,Czech Republic U18,Hlinka Memorial,5,2,3,5,2,6,236429
2016-17,MODO Hockey J18,J18 Allsvenskan,2,0,3,3,6,-2,244393
2016-17,MODO Hockey J20,SuperElit,38,2,5,7,36,0,244393
2016-17,MODO Hockey,Allsvenskan,3,0,0,0,0,0,244393
2016-17,Sweden U18,WJC-18,7,0,0,0,6,-4,244393
2016-17,Sweden U18 (all),International-Jr,17,0,2,2,14,-7,244393
2016-17,Sweden U18,Hlinka Memorial,5,0,2,2,4,0,244393
2016-17,Leksands IF J18,J18 Elit,18,12,16,28,8,,265944
2016-17,Leksands IF J18,J18 Allsvenskan,17,7,14,21,10,20,265944
2016-17,Leksands IF J20,SuperElit,4,3,2,5,0,4,265944
2016-17,Slovenia U18,WJC-18 D1B,5,5,8,13,4,7,265944
2016-17,Slovenia U20,WJC-20 D1B,3,1,2,3,2,0,265944
2016-17,Brynäs IF J20,SuperElit,12,8,9,17,12,7,146700
2016-17,Brynäs IF,SHL,39,8,7,15,2,9,146700
2016-17,AIK,Allsvenskan,2,0,0,0,0,-2,146700
2016-17,Sweden U20 (all),International-Jr,5,1,1,2,0,0,146700
2016-17,Penn State Univ.,NCAA,39,19,28,47,18,24,248278
2016-17,Bili Tygri Liberec,Czech,41,10,12,22,80,11,195562
2016-17,HC Benatky nad Jizerou,Czech2,7,2,5,7,4,2,195562
2016-17,Czech Republic U20 (all),International-Jr,8,4,1,5,37,-2,195562
2016-17,Bili Tygri Liberec,Champions HL,6,1,1,2,2,-3,195562
2016-17,North York Rangers,OJHL,20,9,23,32,18,,273669
2016-17,Spokane Chiefs,WHL,0,0,0,0,0,,201452
2016-17,Team Red,USA-S17,5,4,5,9,-,,201452
2016-17,Blues U18,Jr. B SM-sarja,0,0,0,0,0,,299098
2016-17,Blues U20,Jr. A SM-liiga,46,13,24,37,36,26,299098
2016-17,Finland U18,WJC-18,7,4,3,7,6,1,299098
2016-17,Finland U18 (all),International-Jr,25,9,10,19,30,,299098
2016-17,Finland U18,Hlinka Memorial,4,0,1,1,12,-3,299098
2016-17,Fargo Force,USHL,56,37,23,60,55,24,248398
2016-17,Lethbridge Hurricanes,WHL,29,7,4,11,4,-11,201702
2016-17,Kootenay Ice,WHL,30,11,11,22,14,-35,201702
2016-17,Hamilton Bulldogs,OHL,12,0,1,1,5,3,273694
2016-17,Halifax Mooseheads,QMJHL,64,15,26,41,70,-6,201536
2016-17,Portland Winterhawks,WHL,72,8,15,23,72,5,247160
2016-17,Linköping HC J18,J18 Elit,12,9,6,15,8,10,265290
2016-17,Linköping HC J18,J18 Allsvenskan,10,10,11,21,27,12,265290
2016-17,Linköping HC J20,SuperElit,29,4,5,9,2,2,265290
2016-17,Team Northwest,USHS-MN,21,3,10,13,6,,380612
2016-17,Elk River High,USHS-MN,25,10,30,40,6,,380612
2016-17,Sections 4&7 A/AA,USHS-MN,3,1,0,1,0,,380612
2016-17,Djurgårdens IF J20,SuperElit,11,5,7,12,0,10,187862
2016-17,Djurgårdens IF,SHL,44,3,9,12,16,-6,187862
2016-17,Sweden U20 (all),International-Jr,10,2,5,7,2,1,187862
2016-17,Djurgårdens IF,Champions HL,6,0,0,0,2,0,187862
2016-17,Baie-Comeau Drakkar,QMJHL,66,16,32,48,35,-10,307537
2016-17,Sarnia Sting,OHL,65,14,13,27,16,-1,289231
2016-17,Saint John Sea Dogs,QMJHL,64,5,11,16,26,-6,319958
2016-17,Saint John Sea Dogs,M-Cup,4,2,0,2,0,-1,319958
2016-17,St. Andrew's College,CISAA,11,6,4,10,7,,195024
2016-17,St. Andrew's College,CAHS,46,28,22,50,15,,195024
2016-17,Sioux City Musketeers,USHL,5,0,0,0,2,-3,195024
2016-17,Owen Sound Attack,OHL,67,0,11,11,36,21,239804
2016-17,Drummondville Voltigeurs,QMJHL,65,22,25,47,44,-28,273659
2016-17,Russia U18,WJC-18,7,1,3,4,4,2,273659
2016-17,Selects Hockey Academy 18U,USPHL 18U,6,3,6,9,2,,345585
2016-17,USNTDP Juniors,USHL,8,1,0,1,0,-10,345585
2016-17,U.S. National U17 Team,USDP,6,1,0,1,0,,345585
2016-17,U.S. National U18 Team,USDP,2,0,0,0,0,,345585
2016-17,Team Grey,USA-S17,5,1,2,3,-,,345585
2016-17,CSKA Moskva,KHL,37,4,12,16,42,11,168686
2016-17,Zvezda Chekhov,VHL,2,1,1,2,6,2,168686
2016-17,Russia,EHT,11,1,4,5,6,2,168686
2016-17,Russia (all),International,11,1,4,5,6,2,168686
2016-17,Miami Univ. (Ohio),NCAA,32,10,16,26,14,-2,272540
2016-17,Dubuque Fighting Saints,USHL,53,27,27,54,18,21,201449
2016-17,Team Grey,USA-S17,5,3,2,5,-,,201449
2016-17,Owen Sound Attack,OHL,62,40,58,98,34,31,112892
2016-17,Finland U20,WJC-20,6,0,0,0,2,0,112892
2016-17,Finland U20 (all),International-Jr,7,0,0,0,2,0,112892
2016-17,Elk River High,USHS-MN,25,6,23,29,6,,380606
2016-17,Fairbanks Ice Dogs,NAHL,26,7,9,16,12,3,380606
2016-17,Sections 4&7 A/AA,USHS-MN,3,0,1,1,0,,380606
2016-17,Pelicans,Liiga,8,0,3,3,2,1,92192
2016-17,Peliitat,Mestis,4,2,2,4,4,6,92192
2016-17,Tappara,Liiga,46,11,21,32,78,16,92192
2016-17,Ottawa 67's,OHL,58,21,22,43,20,-24,201447
2016-17,U.S. National U18 Team,USDP,2,0,1,1,2,,201447
2016-17,Team Black,USA-S17,5,2,1,3,-,,201447
2016-17,USA U18,Hlinka Memorial,4,4,5,9,2,0,201447
2016-17,Lukko U18,Jr. B SM-sarja,5,0,3,3,0,,244216
2016-17,Lukko U20,Jr. A SM-liiga,47,1,10,11,14,1,244216
2016-17,KeuPa HT,Mestis,1,0,0,0,0,0,244216
2016-17,Finland U18 (all),International-Jr,8,2,1,3,2,,244216
2016-17,Finland U20 (all),International-Jr,4,0,0,0,6,1,244216
2016-17,Eden Prairie High,USHS-MN,21,10,24,34,16,,344081
2016-17,Team Northwest,USHS-MN,19,5,11,16,12,,344081
2016-17,Bloomington Thunder,USHL,8,1,0,1,0,-3,344081
2016-17,Eden Prairie High,MN State,3,1,1,2,6,,344081
2016-17,Barrie Colts,OHL,29,5,9,14,31,-10,268659
2016-17,Oshawa Generals,OHL,33,7,11,18,50,10,268659
2016-17,Niagara IceDogs,OHL,63,13,37,50,56,-9,273677
2016-17,SDE HF J18,J18 Elit,20,19,13,32,26,25,246501
2016-17,Djurgårdens IF J18,J18 Allsvenskan,14,8,6,14,16,8,246501
2016-17,Djurgårdens IF J20,SuperElit,11,1,0,1,10,-3,246501
2016-17,Halifax Mooseheads,QMJHL,55,4,20,24,44,-25,267626
2016-17,Canada U18,WJC-18,5,0,4,4,2,3,267626
2016-17,Tri-City Storm,USHL,49,19,28,47,4,1,230472
2016-17,Saginaw Spirit,OHL,65,26,21,47,4,-8,297674
2016-17,MODO Hockey J18,J18 Allsvenskan,3,0,2,2,2,4,287706
2016-17,MODO Hockey J20,SuperElit,37,5,10,15,16,14,287706
2016-17,MODO Hockey,Allsvenskan,12,0,1,1,4,1,287706
2016-17,Bloomington Thunder,USHL,60,6,25,31,82,3,196651
2016-17,Jokipojat U20,Jr. A Mestis,22,9,9,18,10,,314467
2016-17,Jokipojat,Mestis,21,1,5,6,6,-1,314467
2016-17,Finland U20 (all),International-Jr,4,1,0,1,0,0,314467
2016-17,Portland Winterhawks,WHL,72,42,42,84,60,29,166653
2016-17,Team Southwest,USHS-MN,20,9,16,25,18,,300078
2016-17,Edina High,USHS-MN,25,22,24,46,6,,300078
2016-17,Lincoln Stars,USHL,4,0,0,0,6,-3,300078
2016-17,Team Royal,USA-S17,5,2,2,4,-,,300078
2016-17,USNTDP Juniors,USHL,16,4,6,10,0,3,273963
2016-17,U.S. National U18 Team,USDP,52,14,13,27,16,,273963
2016-17,USA U18,WJC-18,7,0,3,3,2,5,273963
2016-17,HV71 J18,J18 Allsvenskan,1,1,0,1,4,2,244859
2016-17,HV71 J20,SuperElit,37,15,14,29,59,-2,244859
2016-17,HV71,SHL,2,0,0,0,0,0,244859
2016-17,Sweden U18 (all),International-Jr,8,0,0,0,2,-3,244859
2016-17,St. Andrew's College,CISAA,7,0,4,4,4,,286946
2016-17,St. Andrew's College,CAHS,47,6,27,33,18,,286946
2016-17,Brandon Wheat Kings,WHL,72,2,15,17,38,0,247222
2016-17,Czech Republic U18,WJC-18,1,0,1,1,2,1,247222
2016-17,Czech Republic U18 (all),International-Jr,7,0,2,2,8,2,247222
2016-17,Czech Republic U18,Hlinka Memorial,4,0,1,1,2,3,247222
2016-17,Dynamo Moskva,KHL,19,0,1,1,10,3,312209
2016-17,Dynamo Balashikha,VHL,24,2,4,6,44,-2,312209
2016-17,HK MVD Balashikha,MHL,2,0,1,1,4,5,312209
2016-17,Russian Selects U20,Jr Super Series,6,0,0,0,6,1,312209
2016-17,Luleå HF J18,J18 Elit,15,7,10,17,29,15,316531
2016-17,Luleå HF J18,J18 Allsvenskan,4,2,2,4,12,6,316531
2016-17,Luleå HF J20,SuperElit,13,2,1,3,2,4,316531
2016-17,TPS,Liiga,49,14,12,26,22,9,98096
2016-17,TPS,Champions HL,6,3,3,6,0,5,98096
2016-17,USNTDP Juniors,USHL,25,2,2,4,8,7,311901
2016-17,U.S. National U18 Team,USDP,64,5,8,13,22,,311901
2016-17,USA U18,WJC-18,7,0,2,2,2,7,311901
2016-17,Waterloo Black Hawks,USHL,47,26,25,51,12,29,274245
2016-17,USA U19,WJAC-19,5,2,2,4,0,,274245
2016-17,St. Thomas Academy,USHS-MN,25,8,32,40,20,,300993
2016-17,Team Southeast,USHS-MN,19,0,13,13,40,,300993
2016-17,St. Thomas Academy,MN State,3,1,3,4,0,,300993
2016-17,Shreveport Mudbugs,NAHL,59,12,40,52,125,30,269704
2016-17,Baie-Comeau Drakkar,QMJHL,60,26,33,59,14,-3,333786
2016-17,Russia U18,WJC-18,7,5,4,9,4,3,333786
2016-17,Russia U18,Hlinka Memorial,5,2,2,4,2,4,333786
2016-17,Russia U18,WJAC-19,4,3,6,9,2,,333786
2016-17,Almtuna IS J18,J18 Elit,15,8,4,12,10,1,297223
2016-17,Almtuna IS J18,J18 Allsvenskan,13,2,3,5,56,-1,297223
2016-17,Almtuna IS J20,J20 Elit,19,13,5,18,24,22,297223
2016-17,Almtuna IS,Allsvenskan,1,1,0,1,0,0,297223
2016-17,Norway U18,WJC-18 D1A,5,5,3,8,6,5,297223
2016-17,Sioux City Musketeers,USHL,52,6,22,28,30,19,247916
2016-17,USA U19,WJAC-19,5,0,1,1,6,,247916
2016-17,Lakeville South High,USHS-MN,23,8,20,28,12,,312022
2016-17,Team Southeast,USHS-MN,18,2,11,13,12,,312022
2016-17,Cedar Rapids RoughRiders,USHL,2,0,1,1,4,-1,312022
2016-17,Team Kelly,USA-S17,5,1,2,3,-,,312022
2016-17,Lakeville South High,MN State,3,2,1,3,6,,312022
2016-17,Kingston Frontenacs,OHL,59,1,9,10,36,-18,297973
2016-17,RPI (Rensselaer Polytech. Inst.),NCAA,35,2,13,15,68,-17,250209
